store	店	original
perspective	遠近法の|見込み|遠近(画)法|透視図法|遠近感|観点|展望|将来の見通し	anc
agent	代理人|代理店|行為の主体|媒介|外交員|スパイ	anc
critical	批判的な|重大な|危機的な|きわどい|臨界の	anc
train	列車|訓練する	anc
slowly	ゆっくりと	anc
thank	感謝する	anc
normal	普通の|平均的な|標準の|典型的な|平均値	anc
distribution	流通|分配|配給|区分|配置	anc
length	長さ	anc
user	ユーザー|使う人|消費者	anc
guy	支索|男|やつ|張り綱|支え線	anc
reaction	反応|反作用	anc
firm	会社|商店|企業|医療チーム|固まる|安定させる|固い|堅い|堅固な|頑丈な|安定した	anc
success	成功した人･事|幸運|成功|合格	anc
foreign	外国の	anc
prevent	させない|を妨げる|を防ぐ	anc
volume	(書物の)巻･冊|分冊|本|巻き物|大きな塊|たくさん|容積	anc
professional	知的職業の|プロ|専門的職業の|専門家|職業的な|商売の|本職の|玄人|教授の|学者ぶった|独断的な|故意の	anc
signal	信号(を送る)|合図(する)	anc
enter	に入る|を記入する	anc
exercise	を訓練する|影響を及ぼす|権利を行使する|課題|実行|運動|体操|練習|稽古|学課|機能試験|動作試験	anc
strange	不思議な|妙な|見知らぬ	anc
conflict	衝突する|争う|摩擦|闘争|争い	anc
connection	結びつき|関係	anc
ring	輪|指輪|(ベルなど)が鳴る|を鳴らす	anc
contract	契約|請け負い|約定|協定|規約|契約書|契約する|を協議して決める|の習慣がつく|病気にかかる|婚約する|を縮小する	anc
message	メッセージ|伝言	anc
box	箱	anc
file	綴じ込む|(書類など)を提出する	anc
chair	いす	anc
block	塊|かたまり|ブロック(都市で四辺を道路で囲まれた一区画)|阻止(する)	anc
conversation	話し合い|会話|社交|交際|社交性|座談	anc
aim	をねらう|めざす|目的|意図|purpose	anc
struggle	苦闘する|もがく|努力する|努力|苦闘	anc
lose	失う|負ける	anc
average	平均的な|平均	anc
interaction	相互作用	anc
status	地位|情勢|状態	anc
detail	詳述する|列挙する|細部|詳細|詳説|建築の細部	anc
trouble	問題|悩み|苦労|悩ませる	anc
global	全体的な|球状の|地球の|全地球的|全世界的な	anc
news	ニュース	anc
previous	前の|先の|以前の|予備の	anc
female	女性の|雌の|めしべだけの	anc
central	中央の	anc
easily	容易に	anc
balance	とつり合う|平静|決定権|秤|つりあい|落ち着き|平衡(性)|平均台(balance beam)	anc
negative	マイナスの|否定の|消極的な|陰画の	anc
gaze	じっと見つめる|をじっと見つめる|注視|凝視	anc
safe	安全な|無事な|金庫	anc
procedure	手続き|処置|進行|進展|手順|手段|行動|行為|訴訟手続	anc
command	指揮|命令|眼下に見おろす|命令する|値する	anc
hot	暑い|熱い|(味が)からい	anc
duty	任務|義務|本分|職務	anc
scene	シーン|現場|場面|舞台|眺め	anc
official	公の|公式の|職員|役員	anc
transfer	を移す|を運ぶ|転校する|乗り換える|移動|転任|運搬|乗り換え|版画	anc
ensure	を確実にする|を請け合う|を保証する|を安全にする	anc
appropriate	適切な|適当な|特有な|私物化する|流用する|充当する|専有する|割り当てる	anc
require	必要とする|を要求する|need|demand	anc
stone	石材|石|小石	anc
hit	打つ|を叩く|思いつく	anc
opinion	意見|主張	anc
income	定収入|収入|所得	anc
recent	最近の|近頃の|新しい|近代の|現世の	anc
baby	赤ん坊	anc
laugh	笑う	anc
lady	婦人|女性	anc
imagine	想像する|を心に描く|を仮定する|を推測する	anc
heavy	重い	anc
capacity	引受能力|容量|力量|収容能力|資格|収容力|地位|容積|耐荷重	anc
thought	考えること|考え	anc
device	装置|工夫	anc
warm	暖かい|温かい|思いやりのある	anc
importance	重要性|身分の高いこと	anc
nearly	ほとんど|よく似て|ほぼ|近くに|親しく	anc
master	主人|修士|先生|教師|名人|～長|征服する|習得する	anc
ear	耳	anc
re	について|about	anc
rock	岩|ロック|揺する	original
economy	経済|経済組織|節約	anc
dry	乾燥した|無味乾燥な|面白くない|退屈な|乾かす|辛口の(酒)|(俗)禁酒	anc
medical	医学の|内科の|医学生	anc
option	選択|選択可能物	original
former	前の|以前の|前者	anc
primary	主要な|基礎的な|第1位の|最初の|初期の|本来の|大統領予備選挙|主要な事物	anc
multiple	複合の|倍数の|複式の|複合的な|多様の|倍数	anc
exchange	を交換する|交流|両替|為替	anc
sit	すわる|すわっている	anc
spread	を広げる|広がる|広がり|広めること|スプレッド	anc
damage	評判を傷つける|損害|勘定|損害を与える	anc
code	暗号(にする)|慣例|法典|規約|符号|国際規約	anc
belief	信じること|信用|信頼|信念|意見|信条	anc
assessment	評価	anc
generation	世代|同世代の人々|同年代の人々|発生	anc
expect	期待する|を予期する|予想する	anc
male	男性の|男の|男性的な|男|雄の|おしべだけの	anc
throughout	〜のいたるところで	original
pretty	きれいな|かわいい	anc
board	役員会|議会のテーブル|理事会|取締役会|株式取引所|食卓|板|舞台|厚紙|ボール紙|台紙	anc
travel	旅行|旅行する|(光･音が)伝わる	anc
adult	おとな|成熟した|成人の|成人専用の	anc
article	記事|論文|論説|品物|一品|契約|条項|(文法)冠詞	anc
contrast	対照|正反対のもの|対照させる	anc
mass	大量|集団	anc
respond	に返答する|反応する	anc
basic	基礎的な	anc
belong	所属している|の所有物である	anc
corner	角|隅|窮地	anc
advantage	好都合|有利|利益|長所|便宜|利点|強み	anc
speed	スピード|急ぐ|速力|速さ|速度|速度を増す|を急がせる|(俗)覚醒剤|ヒロポン	anc
except	〜を除いて	original
possibility	可能性|見込み|将来性|実現性|ありうること|起こりうること	anc
failure	不履行|落第した人|失敗した人|失敗|不成功|怠慢|不足	anc
trial	公判|裁判|試験|試み|努力|苦難	anc
mechanism	機構|機械装置|仕組み|手段|メカニズム	anc
rich	豊かな|お金持ちの	anc
faith	信頼|信念|信用|信仰|確信|信じること	anc
guide	案内人|案内書|を案内する	anc
investment	投資|出資|包むこと|包囲|任命|投資金|外皮|封鎖	anc
exactly	正確に|ちょうど	anc
shot	発射|弾丸|射手|shootの過去･過去分詞	anc
fish	魚	anc
event	行事|出来事	anc
slow	速度をおとす|退屈な|遅い|鈍い|遅れている|ゆっくり|遅くなる|を遅くする	anc
moral	道徳の|道徳的な|精神的な|教訓|品行	anc
responsibility	支払い能力|責任|義務|義理|責務|職責|負担	anc
spot	スポット|地点|しみ|吹き出物|見つける|見抜く|しみがつく	anc
clean	きれいな|清潔な	anc
agreement	同意|意見の一致|協定|条約|(文法)一致|呼応	anc
sight	一覧払い|見ること|見えること|視力|名所	anc
equal	等しい|均等な|同等の物|に相当する|平等の|に匹敵する|同輩|イコール	anc
judge	を判断する|を裁判する|裁判官|審判員	anc
spend	お金を使う|(時)を過ごす	anc
throw	投げる|を発射する|を投影する|を投じる	anc
literature	文学研究|文学(作品)|文芸|文献|印刷物|学問	anc
worker	労働者|肉体労働者|仕事をする人|研究者|働きバチ|勉強する人	anc
argue	論争する|と主張する|議論する	anc
interview	インタビュー|インタビューする|面接|会見	anc
student	生徒	anc
client	顧客|お得意様|来訪者|訴訟依頼人|(弁護の)依頼人	anc
map	地図	anc
enemy	かたき|敵|敵国	anc
escape	逃げる|免れる|を避ける|逃亡|逃げ道	anc
location	位置|場所|ロケ|野外撮影	anc
perfect	を完成する|完全な|完了形|完了時制	anc
traditional	伝統的な	anc
fully	すっかり|完全に|全く|十分に|まるまる	anc
cry	(声をあげて)泣く	anc
number	数|番号	anc
ride	に乗る|に乗っていく	anc
highly	高く|非常に|高度に|高貴に	anc
serious	まじめな|真剣な|生真面目な|厳粛な|本気の|重大な|深刻な	anc
river	川	anc
sun	太陽	booqs
style	スタイル|呼ぶ|様式|型|文体|日時計の指針|(植物)花柱	anc
doctor	医者|博士	anc
active	積極的な|活発な|能動態の	anc
ill	病気で|悪く|不親切に|不幸な|悪|不運	anc
machine	機械|組織|乗り物	anc
chest	収納箱|胸郭|金庫|たんす|肺	anc
staff	スタッフ|杖|職員	anc
tend	する傾向がある|しがちである	anc
contribute	に貢献する|の一因となる|寄付する|提供する	anc
soft	やわらかいもの|楽な|柔らかい|穏やかな|優しい|弱い	anc
certainly	もちろんです|必ず|確かに|確実に|そうですとも	anc
member	メンバー|一員	anc
foot	足|フィート(1フィートは約305cm, 12inches)	original
base	基づく|基礎をおく|基礎|根拠|基地|ベース|(文法)語幹	anc
root	植え付ける|根をおろす|声援する|根元|ふもと|先祖|地下茎|(人･土地との)つながり|ルーツ|語根|(数学)ルート	original
discuss	議論する	anc
whatever	どんなでも|物は何でも|どんな事が～とも|どんな～でも|いったい何	anc
powerful	強力な	anc
speech	スピーチ|演説	anc
broad	(軽蔑的に)女|幅の広い|広義の|明白な|下品な|一般的な|明るい|広大な|幅がある|楽しみ|(俗)若い女	anc
load	装填(する)|荷|積載量|重荷|に荷を積む|乗り込む|負荷	anc
raise	を上げる|を育てる|(問題など)を提起する|賃上げ	anc
cup	カップ|茶わん	anc
perform	遂行する|行う|carry out|演じる|演奏する	anc
peace	平和	anc
promote	を促進する	anc
relative	相対的な|比較上の|対応する|親戚|関係を示す|関係詞	anc
protein	タンパク質	anc
bar	禁止する|ふさぐ|柵|法廷|帯|縞|バー|酒場|飲み屋	original
acid	酸|酸性|酸塩基反応(acid-base reaction)|酸っぱい|麻薬|LSD 	anc
straight	まっすぐな|まっすぐに|連続した	anc
enable	を可能にする	anc
village	村|村落	anc
dance	踊る|ダンス	anc
request	要求|願い|需要|懇願|を頼む|を求める	anc
additional	追加の	anc
encourage	を励ます|を促進する	anc
shock	衝撃|打撃|電撃|をぎょっとさせる|を憤慨させる	anc
existence	生存物|現存|実存|存在|実在|生活	anc
frame	(計画などを)たくらむ|を罪に陥れる|言葉を発する|構造|(建物の)骨組み|体格|枠台|組み立てる|構成する	anc
display	展示する|誇示する|を表す|展示|表現|exhibit|show	anc
mental	心の|精神の|知力の|頭の中で行う|精神病の|気の狂った	anc
battle	戦い	anc
freedom	自由|自主|免除	anc
variety	多様性|変化|多種|変化に富むこと|相違|種類	anc
decrease	減る|減らす|減少|(反)increase	anc
sex	性の|性的な|男女の|性別|(集合的)男性|女性	anc
hurt	を傷つける	anc
version	バージョン|見解|意見|説明|変形|異形|翻訳|訳文|訳書	anc
useful	役立つ|有用な	anc
correct	訂正する|正しい	anc
protection	保護	anc
vary	変わる|さまざまである|(形･性質など)を変える	anc
neck	頚状部|首|えり|いちゃつく	anc
historical	史実に基づく|歴史の|史学の|歴史上の|歴史に基づく	anc
track	轍|小道|競技場のトラック|鉄道路線|CDなどの録音の単位|(一周できるものに使う)	original
secret	秘密の|機密|内緒の(事)	anc
marriage	結婚(生活)|結婚式|(密接な)結合	anc
definition	定義	anc
hospital	病院	anc
error	誤り	anc
construction	建築様式|建造|建築|構成|(文法)構文|解釈|説明	anc
afraid	心配して|怖がって	anc
gas	ガスを供給する|むだ話|気体|ガス|= petrol|屁	anc
reader	読者|朗読者|読書家|読本|講師|助手	anc
factor	要素|仲買人|因子|要因|原因	anc
farm	農場	anc
sector	産業部門|セクタ|部門	anc
hide	秘密にする|隠す|隠れる|皮	anc
objective	客観的な|事実に基づく|目的(の)|目的格の	anc
crowd	押しよせる|群集	anc
latter	後者|後の方の|近ごろの	anc
pair	一対|1組の男女|同じ札2枚|1組にする|を結婚させる	anc
maybe	たぶん|ひょっとすると	anc
count	重要である|とみなす|計算|伯爵	anc
shop	買い物をする|店	original
beat	(続けざまに)打つ|負かす|巡回区域	anc
crime	犯罪|罪	anc
mountain	山	anc
drop	落ちる|落とす|滴	anc
relevant	関連した|適切な	anc
relation	関係	anc
benefit	利益|ためになる|恩恵|便宜|給付|給付金	anc
match	に匹敵する|に調和する|試合|競争相手|好敵手|釣り合う人･物	anc
guard	用心する|歩哨|見張り|守る|保護する|を慎む|警戒する|護衛者|番人 (UK英)列車の車掌	anc
admit	(いやなこと)を認める|に入ることを許す	anc
arise	現れる|(問題など)が生じる	anc
sentence	宣告|判決|(の判決を)宣告する|文	anc
wood	木|木材|まき|森|酒だる|ウッド	anc
tradition	正式の財産引渡し|伝統|しきたり|言い伝え|伝説	anc
vision	視力|視覚|見ること|幻|想像力|先見の明|見通し	anc
explore	を探検する|を探求する	anc
extent	程度|範囲	anc
slightly	わずかに|ほっそりと|僅かに	anc
framework	骨組み	anc
build	建てる|つくる	anc
initial	頭文字|初の	anc
bone	骨	anc
army	軍隊|陸軍	anc
tone	に調子をつける|調子|音|口調|色調|傾向|(体の)平常の調子|正常な状態	anc
alternative	代替案|選択肢|二者択一の|代わりの(方法)|新しい	anc
soil	土壌|土|土地|国土|汚す|けがす|汚れ|汚水|肥料	anc
guess	推測する|だと思う|推測|当てずっぽう	anc
worth	値打ちがある|に値する|価値|相当量の|財産	anc
spring	春	anc
daily	毎日の	anc
agency	代理店|機関|媒体|作用	anc
tax	税|課税する|重荷|負担	anc
silence	沈黙|静けさ|黙祷|を沈黙させる|を静める	anc
motion	動き|運動|動作|動議|合図する	anc
religion	信条|宗教|宗旨|宗派|信仰|儀式|宗教学	anc
popular	人気のある	anc
difficulty	困難	anc
justice	正当性|公正|正義|裁判|裁判官|司法|司法官	anc
partner	パートナー|仲間|共同出資者|相棒|と提携する	anc
neither	もまた～ない	anc
station	駅	anc
screen	スクリーン|ふるい|場所を仕切るもの|百葉箱	anc
blow	鼻をかむ|風が吹く|とぶ|息を吹く|打撃|(不意の)精神的打撃|殴り合い|発表する|自慢する|笛が鳴る|(俗)コカイン	anc
internal	本質的な|内の|内部の|体内の|内在的な|国内の	anc
park	公園	anc
print	に印象を与える|を印刷する|を出版する|写真を焼き付ける|影響|印象|印刷物	anc
link	連結する|連接棒|握る|組み合う|たいまつ|輪|きずな|連鎖	anc
mark	記号|目標|印(をつける)|跡(を残す)|値段をつける|特徴づける|マルク(ドイツの通貨単位)	anc
computer	コンピュータ	anc
narrative	物語の|物語|談話	anc
essential	非常に重要な|必須の|絶対必要な|エキスの|不可欠の|本質的要素|要点	anc
progress	前進する|進行|前進|進歩|発展|向上|普及|進む|進歩する	anc
environmental	環境の|周囲の	anc
safety	安全装置|安全|無事	anc
aware	気づいて|に気づいている	anc
assume	と仮定する|を引き受ける|(形態を)とる|のふりをする	anc
chain	鎖	anc
constant	変わらない|定数|不変の|絶え間ない|一定の|不断の	anc
bottom	根拠とする|基づく|水底|船底|根底|下部|下側	anc
define	定義する|定める	anc
establish	を確立する|設立する|(事実など)を確定する|立証する	anc
independent	独立の|他に依存しない|自立の|自治の|自由な	anc
experiment	実験|実験装置|試み|実験する	anc
month	月	anc
circle	旋回する|迂回する|円|軌道|円周|輪|範囲|循環|集団	anc
labor	詳しく論じる|労働(者)|仕事|働く|労務|労働する|骨折る|(乗物などが)骨折って進む	anc
mode	モード|様式|方法|形態|流行|様態|法	anc
sky	空	anc
attitude	態度|心構え|姿勢	anc
waste	を浪費する|浪費|廃棄物	anc
obtain	を得る	anc
metal	金属|鉄道レール|装甲車|材料|気性	anc
title	表題|書名|肩書き|権利|資格|選手権	anc
score	スコア|得点(する)|記録する|非難する|楽譜	anc
violence	狂暴性|激しさ|暴行|乱暴|強姦|冒涜|バイオレンス|暴力	anc
dynamic	動力の|動的な|力学の|動的	anc
sorry	ごめんなさい|ご愁傷様(葬式などで)	anc
impossible	不可能な	anc
double	二倍|二倍の	booqs
collection	収集|取り立て|集じん	anc
witness	証言|目撃者|証人|証拠|を目撃する|署名する|を証言する	anc
reveal	を明らかにする|知らせる|示す	anc
matter	問題|事柄|重要である	anc
miss	女性|小娘|(独身女性の姓の前で)～さん|失敗|ミス|(機会等)逸す	anc
gold	金|元素記号はAu|金製品|金貨|金色(の)|金の	anc
actual	事実上の|現在の|現実の	anc
disorder	無秩序|混乱|不調|乱雑|不規則|の秩序を乱す	anc
quiet	静かな	anc
successful	成功した	anc
feature	特徴|顔立ち|地形|(新聞が)特集する|主演する|(文法)素性|の特徴をなす	anc
strike	打つ(こと)|襲う|突き当たる|思いつく|ストライキ	anc
gun	銃|ピストル|大砲|鉄砲|銃を撃つ|を撃ち落とす	anc
pleasure	楽しみ|快楽|喜び|楽しいこと|好み	anc
gender	(文法上の)性(sex)	anc
bag	鞄	anc
intervention	市場介入|調停|仲裁|介入|干渉|内政干渉|売惜しみ	anc
kitchen	台所|キッチン	anc
song	歌|鳴く声|さえずり	original
fair	公正な|合法的な|有望な|平均の|きれいな|まっすぐ|快晴の	anc
regulation	規則|取り締まり|規定|条例|調節|調整|法規	anc
cancer	癌(ガン)|(C-)蟹座	original
appearance	様子|出現|外観|状況|体裁|登場	anc
formation	形成|編隊|～物|～体	anc
muscle	筋肉|腕力|圧力|強引に押し進む	anc
dear	親愛なる	anc
summer	夏	original
otherwise	別のやり方で|さもなければ|その他の点では	anc
capture	を捕まえる|(注意など)を引きつける	anc
empty	空の|空虚な	anc
equation	均衡	anc
concentration	集中|濃度|選鉱	anc
consideration	考慮|思いやり	anc
extremely	極端に	anc
dinner	ディナー|夕食	anc
gift	天賦の才能|才能|贈物|贈り物	anc
clinical	診療所の|臨床の|臨床治療の|客観的な態度の	anc
ancient	古い|古代の	anc
via	〜を経由して	original
huge	巨大な|でっかい|莫大な|たいした	anc
description	描写|記述|説明	anc
therapy	治療|療法	anc
push	(イメージ:押す力を加える)	anc
none	少しも～ない|だれも～ない|決して～ない	anc
novel	(長編)小説|新しい|珍しい|異常な|新奇な	anc
audience	支持者|聴衆|謁見|観客|観衆	anc
online	オンライン式に|ネットワークに接続されて	anc
injury	傷害	anc
attend	気をつける|に出席する|参会する|伴なう|随行する|看護する	anc
frequency	しばしば起こること|頻繁|頻発|頻度|振動数|周波数	anc
pick	突く|選ぶ|つまようじ	anc
observation	観察|所見|監視|観測|言葉|注目|発言	anc
cycle	周期|周波	anc
resistance	電気抵抗|抵抗|反抗|抗争|反対|妨害|敵対|抵抗力	anc
representation	代表|表現	anc
politics	政治|政治学|政策|政務|政略	anc
hate	ひどく嫌う|することをいやがる|憎む|残念に思う	anc
animal	動物	anc
catch	をつかまえる|(病気)にかかる|を捕らえる	anc
sexual	性的な|性の|雌雄の|有性の|生殖の	anc
wake	起きる|を起こす	anc
purchase	を買う|購入(品)	anc
stock	株|ストック|血統|在庫|貯蔵|株券|国債|社債|切り株|仕入れる|蓄える|貯蔵する|陳腐な|平凡な	anc
survey	を調査する|概観|調査|を概観する|測量する	anc
taste	を味わう|を経験する|味|風味|好み|風情|経験	anc
win	勝つ|に勝つ|を勝ち取る	anc
threat	脅迫|おどし|脅威	anc
manage	管理する|経営する|うまく取り扱う|何とかやり遂げる	anc
boat	船	anc
express	表現する|急行	anc
secure	安全な|確実な|不安のない|確保する|手に入れる|安全にする|保証する	anc
career	経歴|生涯の職業|職業的な|生涯|進行|出世|履歴	anc
narrow	(幅や面積が)狭い|狭くなる|狭い部分	original
cook	(を)料理する|料理人|コック	anc
minute	分|(角度の単位)分 1/60度|覚え書き|議事録|少しの間|ささいな	original
advance	前進|進歩|前進する|を前進させる	anc
mistake	誤り|間違える	anc
combination	結合|組み合わせ	anc
beside	〜のそばで	original
responsible	責任のある|責任の重い|信用のおける|の原因である	anc
tissue	(動植物の細胞の)組織|織物|薄い織物	anc
majority	大部分|大多数|過半数|多数党|成年	anc
garden	庭園	anc
passage	通過|通行|通路|旅行|一節|経過|通過帯域	anc
sin	(主に宗教的な)罪(を犯す)|過失|ばかげたこと	anc
nurse	養成する人|看護婦|乳母|授乳する|看護する|大事に育てる|(思想など)を心に抱く	anc
fellow	匹敵者|男|奴|野郎|仲間|同輩|同僚	anc
external	外の|外部の|外側の|外用の|形式的な|外見|外面|外部	anc
sequence	連続|続発|系列|連続(するもの)|結果|順序	anc