punishment	罰
chronic	慢性的な
bare	裸の
conception	概念
grand	壮大な
lover	恋人
endure	耐える
bird	鳥
acute	鋭い
advocate	支持する
forgive	許す
involvement	関与
reputation	評判
captain	船長
permanent	永続的な
destruction	破壊
helpful	役に立つ
corporation	法人
rough	粗い
pulling	引くこと
curse	呪い
softly	優しく
angel	天使
crazy	狂った
tour	旅行
folk	人々
massive	巨大な
welfare	福祉
plastic	プラスチック
graduate	卒業する
electric	電気の
loose	緩い
license	免許
disability	障害
commission	委員会
holy	神聖な
curious	好奇心旺盛な
anywhere	どこでも
potentially	潜在的に
friendship	友情
southern	南の
beast	獣
correlation	相関
regret	後悔
instrument	楽器
prince	王子
achievement	達成
elect	選ぶ
circuit	回路
scatter	散らす
array	配列
sensor	センサー
retreat	撤退
pitch	投げる
surely	確かに
wooden	木製の
elite	エリート
racial	人種の
legislation	立法
democratic	民主的な
maintenance	維持
sale	販売
glory	栄光
fix	修理する
realm	領域
web	ウェブ
fiber	繊維
react	反応する
analyze	分析する
northern	北の
faint	かすかな
whisper	ささやく
minor	小さい
loop	ループ
award	賞
disaster	災害
classical	古典的な
weakness	弱さ
diet	食事
essay	エッセイ
excuse	言い訳
royal	王室の
pump	ポンプ
shade	日陰
frequent	頻繁な
elsewhere	他の場所で
motivation	動機
discharge	排出する
uncle	おじ
lord	主
cooperation	協力
undergo	経験する
shame	恥
crown	王冠
fairly	かなり
transmission	送信
fracture	骨折
hang	吊るす
musical	音楽の
migration	移住
prime	最重要な
dimension	寸法
comprehensive	包括的な
pipe	管
valley	谷
interact	交流する
ritual	儀式
neighborhood	近所
poetry	詩
paragraph	段落
meeting	会議
mad	怒っている
cousin	いとこ
flower	花
propose	提案する
oral	口頭の
fortune	運
beer	ビール
orientation	オリエンテーション
suspect	疑う
nearby	近くの
employ	雇う
confirm	確認する
plenty	たくさん
favour	好意
pause	一時停止
inform	知らせる
graph	グラフ
anxious	心配している
raw	生の
intent	意図
emphasize	強調する［=emphasize］〈アメリカ英語〉
predict	予測する
confusion	混乱
forehead	額
pop	ポップ
mess	混乱状態
steam	蒸気
normally	通常
draft	草案
successfully	うまく
slope	斜面
para	〜に関して
prediction	予測
multi	多くの
withdraw	撤退する
fist	拳
glow	輝き
fancy	豪華な
velocity	速度
initially	最初に
seal	封印
giant	巨大な
divide	分割する
virus	ウイルス
item	項目
manifest	明らかな
organizational	組織の［=organisational］〈アメリカ英語〉
stupid	愚かな
guidance	指導
mask	マスク
leap	跳躍
chicken	鶏
lovely	かわいい
boundary	境界
expensive	高価な
courage	勇気
und	そして〈ドイツ語〉
empirical	経験的な
decade	10年間
inequality	不平等
venture	冒険
talent	才能
whenever	〜するときはいつでも
crystal	水晶
boss	上司
shit	くそ
tribe	部族
emerge	現れる
western	西洋の
email	電子メール
routine	日課
prospect	見通し
medication	薬
pot	鍋
vital	非常に重要な
administrative	行政の
jurisdiction	管轄権
professor	教授
guilty	有罪の
passenger	乗客
rear	後部
sport	スポーツ
engineer	技術者
grin	にっこり笑う
requirement	必要条件
partly	部分的に
threshold	敷居
excitement	興奮
shower	シャワー
effectiveness	効果
hint	ヒント
prominent	著名な
sensation	感覚
exit	出口
blade	刃
adequate	十分な
cream	クリーム
rational	合理的な
art	芸術
pleasant	快適な
totally	完全に
invite	招待する
faculty	学部
knock	ノックする
yesterday	昨日
sub	下位の
ion	イオン
essentially	本質的に
powder	粉
spite	悪意
spare	余分な
distress	苦悩
slice	薄切り
convey	伝える
denote	示す
magazine	雑誌
enzyme	酵素
unusual	珍しい
rage	激怒
render	与える
inquiry	問い合わせ
mystery	謎
magnetic	磁気の
convince	納得させる
awake	目覚めている
treaty	条約
sacred	神聖な
pour	注ぐ
sustainable	持続可能な
vein	静脈
everyday	日常の
laboratory	実験室
protocol	議定書
pilot	パイロット
duration	期間
cap	帽子
bid	入札
dialogue	対話
deck	甲板
drift	漂う
grateful	感謝している
voltage	電圧
crash	衝突する
honour	名誉
farmer	農民
soldier	兵士
essence	本質
liberty	自由
configuration	構成
kg	キログラム（単位）
rescue	救助する
bathroom	浴室
wing	翼
von	〜の|ドイツ語姓の一部
bell	鐘
ghost	幽霊
thrust	押す
setting	設定
molecular	分子の
tank	タンク
panic	パニック
du	あなた〈フランス語〉
resolve	解決する
chase	追いかける
cave	洞窟
calculate	計算する
pink	ピンク色
compromise	妥協する
recover	回復する
luck	運
laughter	笑い
selling	販売
interpret	解釈する
remote	遠隔の
pen	ペン
instruction	指示
systematic	体系的な
province	州
methodology	方法論
acquire	獲得する
summary	要約
psychology	心理学
disappear	消える
mutual	相互の
reserve	予約する
factory	工場
instantly	即座に
partnership	提携
carriage	馬車
discrimination	差別
fiction	フィクション
accompany	同行する
ongoing	進行中の
acquisition	取得
shelter	避難所
radiation	放射線
newly	新たに
worthy	価値のある
pound	ポンド
accordance	一致
synthesis	合成
remarkable	注目すべき
utility	有用性
county	郡
clause	条項
succeed	成功する
historian	歴史家
format	形式
detect	検出する
handsome	ハンサムな
diagram	図
cure	治療する
arrow	矢
ultimate	究極の
trick	トリック
simultaneously	同時に
complaint	苦情
pregnancy	妊娠
enormous	巨大な
treasure	宝物
trauma	心的外傷
rice	米
chart	図表
profession	職業
assembly	集会
bomb	爆弾
declare	宣言する
horror	恐怖
naked	裸の
episode	エピソード
appointment	予約
ownership	所有権
regulatory	規制の
removal	除去
roar	吠える
occasionally	時折
unlike	〜と違って
clock	時計
le	〜の〈フランス語〉
chin	あご
tender	優しい
constitutional	憲法の
innocent	無実の
nobody	誰も〜ない
undertake	引き受ける
philosopher	哲学者
temporary	一時的な
drag	引きずる
afterwards	その後［=afterward］〈イギリス英語〉
technological	技術の
equality	平等
assistant	助手
brow	額
partial	部分的な
acceptance	受け入れ
sweat	汗
ad	広告
utter	完全な
settle	解決する
poison	毒
conviction	確信
thread	糸
coverage	報道範囲
grey	灰色の
lean	傾く
council	議会
stimulate	刺激する
mate	仲間
que	何〈多国語〉
philosophical	哲学的な
briefly	簡潔に
resemble	似ている
coin	硬貨
del	〜の〈スペイン語〉
min	分
queen	女王
commit	犯す
publisher	出版社
compound	複合の
conservative	保守的な
impose	課す
optimal	最適な
upset	動揺した
lecture	講義
weapon	武器
owner	所有者
rope	ロープ
abstract	抽象的な
waist	腰
conversion	転換
retain	保持する
earn	稼ぐ
ex	元〜
devil	悪魔
regularly	定期的に
dimensional	次元の
personnel	人員
kick	蹴る
violation	違反
sail	帆
thermal	熱の
occupation	職業
urge	強く促す
extraordinary	並外れた
painful	痛い
excess	過剰
demon	悪魔
organize	整理する
parameter	パラメータ
behave	振る舞う
tightly	きつく
moderate	適度な
agriculture	農業
reject	拒否する
un	1つの〈フランス語〉
di	〜の〈イタリア語〉
manuscript	原稿
agenda	議題
cake	ケーキ
mile	マイル
approval	承認
shed	流す
lip	唇
firmly	しっかりと
cheap	安い
diameter	直径
hungry	空腹の
vertical	垂直の
sensitivity	感受性
curriculum	カリキュラム
execution	実行
pin	ピン
applicable	適用可能な
drain	排出する
verb	動詞
stare	じっと見る
classic	古典的な
gather	集める
temporal	時間的な
lucky	運が良い
tent	テント
grief	深い悲しみ
knee	膝
equity	公正
competitive	競争の激しい
regardless	関係なく
interior	内側
statistical	統計の
unity	統一
polymer	高分子
modification	修正
similarity	類似
museum	博物館
opponent	相手
juice	ジュース
attorney	弁護士
divorce	離婚
fever	熱
collaboration	協力
coal	石炭
ideology	イデオロギー
foster	育てる
quote	引用する
arch	アーチ
margin	余白
blanket	毛布
testimony	証言
attract	引きつける
suspicion	疑い
empire	帝国
regulate	規制する
perceive	知覚する
enforcement	施行
logical	論理的な
orange	オレンジ
immune	免疫のある
critique	批評
negotiate	交渉する
flag	旗
explicitly	明確に
vulnerable	傷つきやすい
substitute	代わり
lend	貸す
jaw	あご
aesthetic	美的な
craft	工芸
assault	暴行
lightly	軽く
consult	相談する
pregnant	妊娠している
dragon	ドラゴン
alongside	〜と並んで
battery	電池
pity	哀れみ
equilibrium	均衡
differently	異なって
pro	賛成
fraction	一部
tune	曲
terror	恐怖
precious	貴重な
attractive	魅力的な
vice	悪徳
shield	盾
obey	従う
altogether	完全に
cloth	布
destination	目的地
virtual	仮想の
cabin	小屋
defence	防御
attain	達成する
dramatic	劇的な
besides	〜に加えて
ceremony	式典
adaptation	適応
tunnel	トンネル
jacket	ジャケット
paint	塗料
asset	資産
exploit	活用する
ceiling	天井
activation	活性化
convention	大会
harvest	収穫
castle	城
combat	戦闘
abroad	海外で
pan	鍋
literally	文字通り
everybody	みんな
neighbor	隣人
explicit	明確な
confess	告白する
incorporate	組み入れる
readily	容易に
merchant	商人
el	その（男性名詞単数冠詞）〈スペイン語〉
indication	兆候
belt	ベルト
gay	同性愛者
people	人々
particle	粒子
persuade	説得する
weekend	週末
behalf	代表
funny	面白い
register	登録する
lens	レンズ
bet	賭ける
holiday	休日
eternal	永遠の
adjustment	調整
personally	個人的に
constitution	憲法
valid	有効な
commander	司令官
identical	同一の
mercy	慈悲
linguistic	言語の
electrical	電気の
assignment	課題
secretary	秘書
induce	引き起こす
brave	勇敢な
guilt	罪悪感
reign	統治
compensation	補償
adventure	冒険
residence	住居
composite	複合の
solar	太陽の
meaningful	意味のある
echo	反響
associate	関連づける
patch	当て布
wrist	手首
alter	変更する
profound	深い
intimate	親密な
insist	主張する
tie	結ぶ
pursuit	追求
adoption	採用
wolf	オオカミ
compliance	順守
km	キロメートル
absent	不在の
leather	革
carrier	運搬人
productivity	生産性
scent	香り
lap	ひざ
adjust	調整する
torture	拷問
electricity	電気
artery	動脈
wage	賃金
reliable	信頼できる
thumb	親指
confident	自信がある
bitter	苦い
couch	ソファ
tough	厳しい
strict	厳格な
module	モジュール
elaborate	手の込んだ
overview	概要
genuine	本物の
occurrence	出来事
expenditure	支出
contest	競争
wrap	包む
sentiment	感情
lamp	ランプ
suicide	自殺
twin	双子
acceptable	受け入れられる
fabric	布地
privacy	プライバシー
fence	フェンス
affection	愛情
conceptual	概念的な
justify	正当化する
ticket	切符
neutral	中立の
precise	正確な
recommend	勧める
healthcare	医療
aunt	おば
dawn	夜明け
blend	混合する
cigarette	タバコ
proposition	提案
needle	針
minimize	最小限にする
cheese	チーズ
artificial	人工の
chat	おしゃべり
apple	リンゴ
dirty	汚い
statute	法令
unexpected	予期しない
amongst	〜の間に
inclusion	包含
availability	利用可能性
lifetime	一生
intend	意図する
hook	フック
sufficiently	十分に
trans	トランスジェンダー
ruler	支配者
horizon	地平線
stack	積み重ね
imperial	帝国の
se	自分自身〈スペイン語〉
convert	変換する
punch	殴る
theatre	劇場
monster	怪物
promotion	昇進
default	初期設定
alliance	同盟
heal	癒す
respective	それぞれの
hire	雇う
filling	詰め物
dig	掘る
neural	神経の
slavery	奴隷制度
grandfather	祖父
thoroughly	徹底的に
gut	腸
sympathy	同情
theology	神学
merit	価値
membership	会員資格
guest	客
deposit	預金
aircraft	航空機
prevention	予防
subsequently	その後に
mortality	死亡率
pepper	コショウ
usage	使用法
cope	対処する
desperate	絶望的な
egg	卵
container	容器
grandmother	祖母
occupy	占める
emperor	皇帝
launch	開始する
leaf	葉
elbow	ひじ
facility	施設
lateral	側面の
badly	ひどく
impulse	衝動
expertise	専門知識
governor	知事
eastern	東の
integrity	誠実さ
internet	インターネット
modeling	モデル化［=modelling］〈アメリカ英語〉
enforce	施行する
assert	主張する
currency	通貨
surgical	外科の
forbid	禁じる
unlikely	ありそうにない
curtain	カーテン
mobility	移動性
departure	出発
behavioral	行動の［=behavioural］〈アメリカ英語〉
therapeutic	治療の
server	サーバー
bench	ベンチ
cultivation	耕作
mineral	鉱物
breach	違反
archive	保管所
brilliant	素晴らしい
stake	賭け金
genre	ジャンル
drama	ドラマ
integrate	統合する
curiosity	好奇心
temper	気質
judicial	司法の
cattle	牛
hierarchy	階層
blank	空白の
formulation	構成
differential	差異
physically	身体的に
relax	くつろぐ
eager	熱望している
dignity	尊厳
prophet	預言者
attachment	添付
sustain	持続する
transportation	輸送
overlap	重なる
derivative	派生物
invest	投資する
stimulus	刺激
progressive	進歩的な
comparative	比較の
surrender	降伏する
rhythm	リズム
affair	出来事
freely	自由に
manufacture	製造する
somebody	誰か
chill	冷やす
alert	警戒
sole	唯一の
bullet	弾丸
mathematical	数学の
paradigm	枠組み
shout	叫ぶ
widespread	広範囲の
revolutionary	革命的な
unconscious	無意識の
tape	テープ
myth	神話
bound	縛られた
metaphor	隠喩
restore	回復する
illustration	例示
sheep	羊
legitimate	正当な
regression	後退
ache	痛み
snake	ヘビ
script	台本
roughly	おおよそ
span	期間
delicate	繊細な
charm	魅力
indigenous	先住の
laser	レーザー
cow	雌牛
telephone	電話
uncomfortable	不快な
scratch	ひっかく
audit	監査
heritage	遺産