saving	節約する|救いの|節約|倹約(の)	anc
frank	フランク(F-人名)|あからさまな|無料送達する|率直な|公然の	anc
graphic	グラフィック|グラフの|図画の|グラフィックアートの|目のあたりに見るような|生きいきとした	anc
associate	関連づける|連想する|つきあう|仲間|同僚	anc
processor	処理装置	anc
insert	挿入する	anc
zoom	急上昇|急上昇する	anc
submission	服従|従順|寄託|提案|提出|仲裁付託|(レスリング)押さえ込みに屈すること	anc
surprise	驚き|を驚かせる	anc
hang	掛ける|つるす|絞首刑する･になる	anc
broadcast	放送する|広く|放送	anc
trailer	トレーラー|引く人|追跡者|予告編|キャンピングカー	anc
capture	を捕まえる|(注意など)を引きつける	anc
anonymous	匿名の	anc
miscellaneous	雑多な|種々雑多の|種々雑多なものからなる|多方面の	anc
revision	改訂|改正|手直し|加筆|是正|校閲|改訂版|復習	anc
dot	点を打つ|小数点|点	anc
territory	販売区域|領土|地域|地方|分野|領域|縄張り	anc
trouble	問題|悩み|苦労|悩ませる	anc
clearly	明瞭に|はっきりと|明るく	anc
vintage	(ある特定地域･時期の)ぶどう酒|古くて価値のあるもの	anc
lease	賃貸契約|(土地･建物など)を賃貸する|賃借する	anc
seminar	セミナー	anc
substance	実体|物質|実質|内容|財産|大要|薬物|麻薬	anc
adapter	改作者|翻案者|アダプター	anc
generate	生成する|発生させる	anc
diff	差分(二つの値の差)	anc
bonus	ボーナス|特別配当金|思いがけない贈り物	anc
frequently	しばしば|頻繁に	anc
reform	改革する|改心させる|改正する|改善する|を矯正する|革新|感化	anc
zero	0|ゼロ	anc
tip	先|頂点|(内々の)情報|警告|(コンピューター)チップ|祝儀|を傾ける|を開ける|を捨てる|に先をつける	anc
euro	ユーロ|EUの通貨	anc
advisor	忠告者(主に米式綴り)	anc
ratio	割合|比例|比	anc
negative	マイナスの|否定の|消極的な|陰画の	anc
whatever	どんなでも|物は何でも|どんな事が～とも|どんな～でも|いったい何	anc
math	数学|mathematics	anc
intelligence	知性|知力･知能|(他国に関する)情報|諜報	anc
checkout	チェックアウト|精算|精算カウンター	anc
junior	年少の|年少者	anc
exactly	正確に|ちょうど	anc
concert	コンサート|音楽会|演奏会|調和|一致|呼応|囃子|合奏|合唱|合意で解決する	anc
tone	に調子をつける|調子|音|口調|色調|傾向|(体の)平常の調子|正常な状態	anc
nearly	ほとんど|よく似て|ほぼ|近くに|親しく	anc
eligible	資格のある|望ましい|適任者	anc
applicant	志願者|応募者	anc
gaming	賭博	anc
extreme	極端な|非常な|極度の|過激な|最後の|窮境|危機|最後の手段	anc
mechanism	機構|機械装置|仕組み|手段|メカニズム	anc
circle	旋回する|迂回する|円|軌道|円周|輪|範囲|循環|集団	anc
interaction	相互作用	anc
shift	を変える|移す|変化|移動|交替	anc
anime	アニメ|アニメーション	anc
plug	差し込み|消火栓|栓|プラグ|ソケット|点火栓|をふさぐ|宣伝(する)	anc
solve	を解決する	anc
con	反対の	anc
plain	明白な|質素な|率直な|(味が)あっさりした|平原|平野	anc
residential	住居の	anc
treat	を扱う|を手当てする|楽しみ|喜び|おごり	anc
burn	燃やす|火傷	anc
academy	専門学校|学士院	anc
seed	種|をまく|種をまく|(スポーツ)シードする	anc
matrix	母体|(数)行列|鋳型|字母|マトリックス|素地	anc
principal	重要な|主要な|第1の|元金の|主役|支配者|校長|社長|主犯|第一債務者	anc
sing	(を)歌う	anc
identity	身元|正体|独自性	anc
spam	スパム	anc
sky	空	anc
consideration	考慮|思いやり	anc
compatible	両立できる|矛盾のない|(ソフトウェアなどで)互換性がある	anc
genre	類型|形式|様式|ジャンル|風俗画(の)|特殊な技術･ストーリー･セットを使用した映画	anc
fruit	くだもの	anc
rural	rural|都会(urban)に対し|田舎(いなか)風の|田園の	anc
repeat	繰り返す|くり返して言う|他言する|暗唱する|反覆|複写|写し	anc
null	無効の|無価値の|特色(表情)のない|存在しない|零(の)	anc
audit	監査|(帳簿など)を検査する|(講義)を聴講する	anc
recreation	リクリエーション|レクリエーション|気晴らし|娯楽|休養|保養	anc
strategic	戦略上の|(巧みな)戦略(上)の|計略の|有利な	anc
certification	証明書|認可|保証	anc
economics	経済学	anc
landscape	の風景を美化する|庭師をする|景色|風景画	anc
deposit	預かり|積立金|保証金|堆積物|埋蔵物|を堆積させる|を預ける|を貯金する|挿入する|蒸着する|溶着する	anc
apartment	アパート	anc
comfort	を慰める|元気付ける|安心させる|楽しみ	anc
peak	頂点|峰|最高点|先端|を最高にする	anc
debate	討論(する)|討議|熟慮|論議する|を熟考する	anc
exclusive	排他的な|専門的な	anc
tank	タンク|水槽|戦車	anc
rain	雨が降る|雨	anc
perspective	遠近法の|見込み|遠近(画)法|透視図法|遠近感|観点|展望|将来の見通し	anc
lib	(〜)解放(liberation)	ejdict
prescription	処方(箋|薬)|指示|規定|規範|法規|時効|おきて	anc
decide	決める|決心する	anc
infrastructure	基幹施設|経済基盤|会社の基礎設備	anc
manner	方法|態度|行儀|風習|様式|礼儀作法	anc
beta	(第2ギリシア文字)ベータ|Β|β|ベータ星(星座の中で2番目に明るい星 cf|α星)	anc
paragraph	節にわける|段落|小記事(を書く)|を段落に分ける	anc
rare	まれな|めずらしい|特別すぐれた|(空気など)希薄な	anc
strip	人から(栄誉や地位を)奪う|を裸にする|細長い一片	anc
lane	狭い道|小道|通路|小径	anc
exposure	露出|暴露	anc
pub	パブ|イギリスで発達した酒場のこと|Public Houseの略	anc
toll	死傷者数(number of death)|損害|料金|報酬|徴収する|(鐘など)を鳴らす	anc
experiment	実験|実験装置|試み|実験する	anc
holder	入れもの|所有者|入れ物|所有|支える	anc
gratis	無料で|ただで|ただの	ejdict
upload	アップロード	anc
gender	(文法上の)性(sex)	anc
legislation	法律制定|法規|法律|法	anc
biography	一代記|伝記	anc
dish	大皿|盛り皿|盛付け料理|(口語)かわいこちゃん	anc
bell	鈴をつける|鈴	anc
jazz	ジャズ	anc
chairman	司会者|議長|座長|委員長|会長	anc
toward	〜の方へ	original
philosophy	哲学|哲理|人生観|達観	anc
lingerie	婦人用下着|ランジェリー	anc
gate	門|門に似た狭い通路	anc
slightly	わずかに|ほっそりと|僅かに	anc
ultimate	根本的な|究極|最終の|究極の|究極点	anc
conversion	転換|換算|転向|交換	anc
maker	製造業者|創造主	anc
postal	郵便局の|郵便(局)の	anc
interior	インテリア|内部|奥地|中にある|内側の|内地の	anc
oz	重さの単位|1オンス=約28|3グラム	anc
yard	庭	anc
dual	(文法)双数の|二者の|二重の|二つの部分から成る	anc
episode	挿話	anc
extend	を広げる|延長する|広がる|伸びる	anc
static	静止した|空電|静的な	anc
proof	証明|証拠|試験|論証|に耐える|検査済みの|保証付きの|校正刷り	anc
factory	工場|代理店	anc
tea	茶|ドレミのシ(Doe,Ray,Me,Far,Sew,La,*)	original
accuracy	精密さ|正確|精度	anc
shower	に水を注ぐ|にわか雨|夕立	anc
specify	明白に記す|記入する|を明細に述べる|を指定する|を明細書に記入する	anc
soil	土壌|土|土地|国土|汚す|けがす|汚れ|汚水|肥料	anc
hip	しり|センスのある|流行最先端の|臀部|腰|賢い	anc
moon	月	booqs
array	陣列|隊列|装い|整列させる	anc
guard	用心する|歩哨|見張り|守る|保護する|を慎む|警戒する|護衛者|番人 (UK英)列車の車掌	anc
highway	主要ルート|ハイウェイ|幹線道路	anc
audience	支持者|聴衆|謁見|観客|観衆	anc
novel	(長編)小説|新しい|珍しい|異常な|新奇な	anc
practical	実際的な|現実的な|役に立つ|実地の|経験豊かな	anc
famous	よく知られた|有名な|名高い	anc
violence	狂暴性|激しさ|暴行|乱暴|強姦|冒涜|バイオレンス|暴力	anc
cape	肩マント|岬|ケープ	anc
preparation	準備|用意	anc
admission	入場|入学|許可|告白	anc
permanent	永久の|(半)永久的な|永続する|耐久の|常設の	anc
agriculture	農業|農業の|農学	anc
cancel	無効にする|取消し	anc
folk	(特定の)人々|town folk 町の人たち|(people のほうが一般的)	anc
conclusion	結論|結末	anc
realize	理解する|を悟る|を実現する	anc
tower	塔|やぐら|要塞|とりで|そびえる	anc
configure	作る|構成する	anc
originally	独創的に|もとは|元は|元来|本来|初め|始め|元々	anc
keyboard	キーボード|鍵盤	anc
producer	生産者|演出家|製作者|興行主|経営者	anc
provision	供給|用意	anc
regulation	規則|取り締まり|規定|条例|調節|調整|法規	anc
secondary	二流の|衛星|代理人|第2の|二次的な|補助的な|(学校･教育が)中等の	anc
entity	存在|存在物|実在物|存在者|自主的なもの|独立的なもの|自主性|独自性|実在	anc
nutrition	栄養物摂取|栄養物|滋養の|食物	anc
turkey	トルコ共和国|七面鳥	original
bottle	瓶	anc
wonderful	すばらしい	anc
neighborhood	近所の人々|近所|付近	anc
ticket	切符	anc
majority	大部分|大多数|過半数|多数党|成年	anc
tournament	トーナメント|試合|競技|選手権大会	anc
proceed	進む|～しはじめる	anc
prevention	防止|予防	anc
commitment	献身|傾倒|約束	anc
instant	切迫した|瞬間	anc
presence	プレゼンス|存在|物腰|面前|居ること|存在すること|出席|同席|人前|参列	anc
automatic	自動的|自動の	anc
whom	だれに|だれを|するところの人|そしてその人を	anc
soccer	サッカー	anc
calculator	計算機	anc
tune	曲|ふし|旋律|調べ|正しい調子|の調子を合わせる	anc
serial	(番号などが)連続的な|連載の|連載物|続き物|連続番組|連続もの	anc
resume	再会する|回復する|占める|を取り返す|履歴書(=curriculum vitae)	original
decrease	減る|減らす|減少|(反)increase	anc
lift	解除する|向上させる|持ち上げる|高揚|昇進|助力|リフト	anc
specialty	専門|名物|特徴	anc
healthcare	ヘルスケア	anc
participation	関与|参加|加入|にあずかること	anc
pad	当て|詰め物|当て物|に詰め物をする|を長引かせる	anc
coat	の表面をおおう|めっき|覆う	anc
ideal	理想にかなった|理想|極致|基準|観念的なもの|最上の|典型	anc
broad	(軽蔑的に)女|幅の広い|広義の|明白な|下品な|一般的な|明るい|広大な|幅がある|楽しみ|(俗)若い女	anc
removal	除去|移動	anc
actor	俳優	anc
toy	おもちゃ|おもちゃの|つまらぬもの|もてあそぶ|いいかげんに扱う	anc
threat	脅迫|おどし|脅威	anc
twin	双子の片方|双子|似た者の一方	anc
ahead	前もって|前方に	anc
genetic	遺伝子の|発生の|起源の	anc
utility	ユーティリティ|役に立つこと|役に立つもの	anc
ink	インク|調印する|sign	anc
spy	ひそかに調査する|密かに見張る|スパイ	anc
delta	(第4ギリシア文字)三角州|デルタ|Δ|δ	anc
attachment	取付け|付着|接着|吸着|付着物|付属物|付属部品	anc
salt	塩(の)|塩辛い|刺激|に塩をかける	anc
despite	〜にも関わらず	original
proper	適切な|正しい|礼儀正しい|正常の|固有の|(名詞の後ろで)厳密な意味での	anc
buddy	親友|仲間|相棒	anc
contemporary	現代の|最新の|同時代の|同時期の人|同年齢の人	anc
cartridge	カートリッジ|パトローネ|薬包|弾薬筒	anc
blonde	金髪の	anc
mill	ひき臼|製粉機|水車場|工場|圧搾機|製粉する	anc
alpha	(第1ギリシア文字)アルファ|Α|α	original
cream	クリーム|乳脂|最良の部分	anc
exit	出口	anc
percentage	パーセンテージ|百分率|割合|手数料|利益	anc
loop	環状をなす折返し点|輪|中心点|に巻き付ける|輪になる|宙返り飛行する|ループ|を輪にする	anc
collect	を集める|を徴収する	anc
dinner	ディナー|夕食	anc
inspection	検査	anc
nurse	養成する人|看護婦|乳母|授乳する|看護する|大事に育てる|(思想など)を心に抱く	anc
empty	空の|空虚な	anc
hey	おい!|ちょっと|おい	anc
chamber	公式の間|議場|議院|会議所|室|寝室|貸室	anc
previously	以前は|前もって	anc
bureau	官庁の局|事務局(an information bureau案内所)|化粧ダンス	anc
accident	天災|偶然|事故|災難	anc
building	建物	anc
customize	を注文で特製する	anc
miller	粉屋|製粉業者|フライス盤	original
adobe	日干しレンガ	original
exhibit	展覧する|公開する|展示品|展示する|証拠	anc
header	(くぎなどの)作頭機|穂摘み機|(俗)さかさ飛込み|ヘッディングによるシュート(パス)	anc
router	ルーター	anc
folder	書類はさみ|折りたたみ器|紙挟み|折りたたみパンフレット	anc
ram	雄羊|杭打ち機|RAM(Random Access Memory|コンピュータ記憶装置	anc
luxury	豪奢な(品)|ぜいたく|快楽|贅沢(品)|おごり|満足|贅沢な	anc
advisory	助言の|顧問の|諮問の	anc
introduce	を紹介する	anc
wrap	を包む|包装紙|覆うもの	anc
hate	ひどく嫌う|することをいやがる|憎む|残念に思う	anc
verify	証明する|が本当であることを証明する|を立証する	anc
plot	(陰謀など)を企てる|構想をねる|地区|小区画の土地|脚色|筋	anc
salary	棒給|給料|サラリー	anc
nearby	すぐ近くの|すぐ近くに|すぐ隣に	anc
villa	(大)別荘|いなかの(大)邸宅|(UK英)郊外住宅	anc
annotation	注|注釈	anc
complaint	不平|グチ|不満|(民事の)告訴|病気	anc
bio	バイオ	anc
certainly	もちろんです|必ず|確かに|確実に|そうですとも	anc
muscle	筋肉|腕力|圧力|強引に押し進む	anc
outlet	(チェーンの)店(｢販売代理店｣が原義)|販路|小売店|コンセント|出口|はけ口	anc
indeed	本当に|実に|全く|実際は|なるほど|いかにも	anc
examination	試験|調査	anc
virgin	純潔の|未婚婦人|修道女(まれ)	anc
reaction	反応|反作用	anc
anyway	とにかく	anc
ignore	(意図的に)無視する|怠る|知らないふりをする	anc
jacket	ジャケット|上着|被覆物|カバー|(動物の)毛皮	anc
province	分野|州|地方|国|県|田舎|地域|省|範囲	anc
trademark	商標|登録商標	anc
notification	通知書	anc
exception	例外|除外|異論|異議	anc
exceed	(程度･限度など)を越える|を凌ぐ|より大きい|に優る	anc
storm	突入する|強襲する|嵐(が吹く)|暴風	anc
backup	バックアップ	anc
mostly	たいていは|大部分は|主に	anc
noise	(不快で非音楽的な)音|騒音|騒がしさ|雑音|言い触らす	anc
relief	(苦痛などを)取り除くこと|安心|休息|救援|救済	anc
pilot	パイロット|水先案内人|を導く|を通す|試験的な|(ガスの)口火	anc
athletic	運動競技の	anc
evil	不吉な|悪|悪い|邪悪な|不運の	anc
optical	光学上の|眼の	anc
curriculum	教育課程|カリキュラム	anc
transmission	変速機|送信|伝達|伝染|伝導|発信	anc
hiv	ヒト免疫不全症ウイルス	wnjpn
algorithm	アルゴリズム|演算手順	anc
equivalent	同価値の|～相当の|等価な物|等しい|同等物	anc
reasonable	道理にかなった|思慮分別のある|適度な|妥当な	anc
chocolate	チョコレート	anc
width	幅|広さ	anc
broadband	ブロードバンド	anc
combine	を結合させる|組み合わせる|結合する	anc
importance	重要性|身分の高いこと	anc
blogger	ブロガー|ブログを運営する人	anc
marketplace	市の開かれる広場|売り込み市場	anc
onto	〜の上へ	original
compact	ぎっしり詰まった|コンパクトな|小型車|小型|(二国間または多国間の)盟約|盟約を結ぶ	anc
crack	〜にひびを入れる|割る|神経が参る|コカイン|パリッ|ピシッ|雷の音	original
encyclopedia	百科事典|百科辞典	anc
terminal	死に至る|終末の|終点|ターミナル|3端末|端子	anc
recipe	調理法|製法|処方箋|方策|手段	anc
sentence	宣告|判決|(の判決を)宣告する|文	anc
constant	変わらない|定数|不変の|絶え間ない|一定の|不断の	anc
tennis	テニス	anc
formula	公式|方式|式辞|調合乳	original
broker	ブローカー|仲買人	anc
generic	ノーブランドの|属の|一般的な|包括的な|(文法)総称的な	anc
rapid	速度が速い|急速な|早急の|険しい	anc
charter	に特許を与える|憲章|憲法|constitution	anc
specifically	明確に|特に	anc
lifestyle	生活様式	anc
honor	名誉(となるもの)|光栄|尊敬|栄誉を授ける	anc
converter	改宗させる人|転炉|(原子力)転換炉|(電気)変換器	anc
conservation	保存|保護|維持|国家管理	anc
lecture	小言を言う|講演|講義する|講義|説教	anc
climate	風土|気候|地方|地帯|土地	anc
evolution	進化(論)|発展|展開|考案|旋回|放出	anc
obligation	負担|恩義|義務|債券|債務|義理|お陰	anc
camcorder	カムコーダー|カメラ一体型VTR	anc
usage	用法|使用法	anc
oak	オーク材の|オーク|カシ|ナラ	anc
discovery	ディスカバリー	anc
modify	修正する|緩和する|修飾する	anc
yeah	はい	anc
taste	を味わう|を経験する|味|風味|好み|風情|経験	anc
census	人口調査|国勢調査|個体数調査|の人口を調査する	anc
wash	洗う|を押し流す	anc
bathroom	バスルーム|トイレ	anc
gnu	ヌー|ウシレイヨウ	anc
prince	王子|王|皇族|皇子|プリンス|公爵|君主	anc
visa	査証|裏書き|ビザ|旅券に裏書きをする|ビザを与える	original
appendix	付属物|(俗)盲腸	anc
transit	通過する|運送|推移|通過|経過|通行|運搬|輸送	anc
hop	跳躍|ぴょんと跳び越す|(植物)ホップ|ホップの実(ビールの苦味をつける)|麻薬|阿片	anc
exam	試験|examination	anc
aware	気づいて|に気づいている	anc
puzzle	を当惑させる|困らせる|難問|パズル	anc
alliance	同盟|連合|提携|協力	anc
sum	金額|合計|(～を)要約する|(～を)合計する	anc
lamp	ランプ|光明|灯火|を照らす	anc
banner	旗|標語を書いた旗じるし|(第一面トップの)全段抜きの大見だし|(歓迎の)垂幕|横断幕	anc
wet	を濡らす|湿る|に小便をする|濡れた|保存された|酔った|雨降りの|禁酒反対者|湿気	anc
alcohol	アルコール	anc
legend	言い伝え|伝説|題銘|表題|解説	anc
estimate	推定する|評価する|見積もり	anc
shell	骨ぐみ|貝殻|殻|外観	anc
organic	有機体の|器官の|基本的な|有機物(の)|器質的	anc
eagle	ワシ|鷲|米国の国章|イーグル	anc
scope	範囲|余地|機会|作用域	anc
sharp	明敏な|鋭い|急な|はっきりした|激しい|きびしい|鋭敏な|ちょうど	anc
interracial	異人種間の	anc
competitive	競争が激しい|競争力がある	anc
poetry	詩歌|詩|韻文|詩集|作風	anc
pipe	パイプ|導管|きせる|1服分|導管で導かれる|を吹く	anc
pan	鍋|酷評|酷評される	booqs
bone	骨	anc
representation	代表|表現	anc
extent	程度|範囲	anc
glossary	用語解説|語彙解説|小辞典	anc
possibility	可能性|見込み|将来性|実現性|ありうること|起こりうること	anc
accordance	一致|授与	anc
controller	支配者|管理人|制御(操縦)装置	anc
accurate	明確な|的確な|正確な	anc
inventory	物品明細表|在庫|在庫リスト	anc
convert	を転換する|change|改宗させる	anc
announce	を発表する|を知らせる	anc
playstation	プレイステーション(ゲーム機)	anc
instruction	教授|教育|指令|指図|使用説明書	anc
raw	原料のままの|すり傷|生の|生焼けの|未加工の|ひりひり痛む	anc
concentration	集中|濃度|選鉱	anc
split	株式の分割|割る|分け合う|割り勘にする|を分裂させる	anc
assignment	割り当て|譲渡|指示|宿題|仕事|任務|任命|指摘	anc
husband	夫|(v)倹約･節約する	anc
aircraft	航空機|飛行機	anc
efficiency	能力|効率	anc
compensation	補償|給与|報酬|代償|補正|補強	anc
mouth	口	anc
catalogue	目録を作る|カタログ	anc
worry	心配する	anc
governor	統治者|知事|総督|親方|雇い主|支配者	anc
fox	キツネ|狐|狡猾な人|すごい美人	anc
mathematics	数学|計算|数学の|全く厳密な	anc
plane	飛行機	anc
lie	横たわる|横になる|寝る|うそ|詐欺	original
dean	学部長	anc
explorer	探検家	anc
shock	衝撃|打撃|電撃|をぎょっとさせる|を憤慨させる	anc
outline	外形|輪郭|概略|の輪郭を描く|要点を述べる	anc
smile	ほほえむ|にっこり笑う	anc
tube	地下鉄|パイプ|管|筒|管楽器|チューブ	anc
innovation	(技術)革新|刷新|新機軸	anc
bulletin	公報	anc
logic	ロジック|論理学|論理|道理|理詰め	anc
heritage	文化的遺産|遺産|相続財産	anc
kid	子供|若者青年|子ヤギ|子ヤギの革 2|からかう|ふざける	anc
builder	大工|工務店	anc
comedy	喜劇	anc
consultation	相談|会議|協議	anc
mesh	網目|網の目|網|わな|網で捕らえる|かみ合わせる|協力させる	anc
coordinate	調和して動く|調整する|統一させる|釣合|(文法)等位の	anc
florist	花屋の人	anc
prize	賞|賞品	anc
immediate	すぐ隣の|直後の|即座の|当面の	anc
agricultural	農業の	anc
meal	食事	anc
acquisition	習得	anc
reverse	を反対にする|逆転する|逆(の)|反対(の)	anc
strange	不思議な|妙な|見知らぬ	anc
transition	移行|変遷|変化|移り変わり|推移|過渡期|変わり目|政権移行期	anc
institution	公共機関	anc
analyst	分析家|解説者|解剖学者|分解者|精神分析(学)者|金融アナリスト|財務分析者	anc
rear	を育てる|を築く|起こす|背面|背後|尻|臀部	anc
cluster	かたまり|束|一団|群集|(花|果実の)房|群がる|房になる	anc
yield	産する|を生ずる|与える|明け渡す|負ける|出産|収穫	anc
classroom	教室	anc
totally	すっかり|全く|entirely	anc
doubt	を疑う(don't believe)|疑い	anc
inquiry	問い合わせ|問合せ|質問	anc
setup	装備|構成	anc
proceedings	手続き	anc
identification	身元確認|身分証明|同一視|一体化	anc
chemistry	化学|相性	anc
moderator	仲裁者|減速材	anc
utc	協定世界時間	original
pregnancy	妊娠|豊富	anc
extremely	極端に	anc
costa	肋(ろっ)骨;肋骨状の部分	ejdict
holy	信心深い|神聖な	anc
matt	(表面が)光沢がなくくすんだ|(写真など)つや消しの(面)|の表面をつや消しにする	anc
console	悲しみを和らげる|を慰める|を元気づける	anc
charm	をうっとりさせる|魅力的である|魅力|魔力|護符|お守り	anc
psychology	心理学|心理|性格|心理状態	anc
peer	仲間|同僚|同等の人|貴族|上院議員|(目を凝らして)じっと見る	anc
crash	衝突|墜落|ガチャンと壊す|一時的な熱中|盗みに押し入る	anc
witness	証言|目撃者|証人|証拠|を目撃する|署名する|を証言する	anc
anywhere	どこにも|どこかに	anc
ancient	古い|古代の	anc
breed	(動物が子を)産む|(鳥が卵を)かえす|(人を)養育する(up)	anc
commit	(罪など)を犯す|をゆだねる|委任する	anc
wildlife	野生生物	anc
elementary	初歩の|初めの|初等の|基本の	anc
giant	巨大な|巨人|巨漢|才能･知力などを備えた人	anc
sugar	砂糖スプーン一杯|砂糖|角砂糖一個	anc
angle	(物を見る)角度|ネジ山角|(悪だくみの)魂胆|魚釣りをする|(悪い意味)策略を用いて得ようとする	anc
packet	小包|束|包み|小荷物|小さな束|大金|通信の単位	anc
unlimited	限りない|限定していない|無制限の|無限の|無尽蔵の	anc
hardcover	堅表紙(本装訂)の(本)	anc
empire	帝国	anc
guidance	手引き|案内|指導	anc
egg	卵	anc
printable	印刷できる;出版に適した	ejdict
enforcement	励行|施行|権利の行使	anc
medication	薬物(療法･処理･適用)|投薬	anc
skill	熟練|巧妙|手腕|技能	anc
alarm	をぎょっとさせる|おびえさせる|警告|驚き|不安	anc
appointment	取決め|(人と会う)約束|地位|選定|指定|任命	anc
drum	太鼓|ドラム	anc
belt	～地帯|海峡	anc
venue	会場|集合場所|(行動･事件の)現場	anc
hero	主人公|英雄|偉人|ヒーロー	anc
liquid	不安定な|液体(の)|流動性の|流暢な|透明な	anc
exhibition	見せること|展覧会|公示|発揮|展示|展覧|出品物	anc
nw	北西	wnjpn
donate	寄付(寄贈)する	anc
kick	蹴る|はね返る|蹴ること|コカインなどのドラッグから刺激を得る|(俗)楽しみ|興奮	anc
fiscal	国庫収入の|財政上の|会計の|国庫の|収入印紙|財務の	anc
infection	伝染病|伝染|感染|感化|影響	anc
cotton	綿織物|綿	anc
crazy	気がくるった|無茶な	anc
pure	純粋な|混じりけのない|純血の|清らかな|すっきりした|単なる|音が澄んだ	anc
clinic	臨床講義|診療室|クリニック	anc
pen	ペン	original
violation	違反|侵害|妨害|暴行|強姦	anc
graph	グラフ|図式	anc
retirement	退役|退職|隠退|引退|退去|勇退	anc
vitamin	ビタミン	anc
supplier	原料供給国|供給者|仕入先|業者|供給業者|納入業者	anc
thumbnail	親指のつめ|非常に小さいもの|サムネイル	anc
hell	修羅場|地獄|生き地獄|～なんてとんでもない	anc
requirement	要求されるもの|必要条件	anc
biology	生物学|生態学	anc
dental	歯の|歯科(用)の|歯音(の)	anc
argue	論争する|と主張する|議論する	anc
ref	レフリー|審判|審判をする|仲裁をする|の仲裁をする	anc
clearance	取りかたづけ|手形交換|掃除|間隔|隙間	anc
mystery	推理小説|神秘|秘密|謎|ミステリー|手工芸	anc
leisure	ひま|暇(な)|余暇|用事のない|有閑の|レジャー	anc
fabric	織物|布|繊維|構造|組織|建物	anc
beer	ビール	anc
kernel	核心|核|仁	anc
historic	歴史上重要な|歴史上の|歴史的に有名な|歴史に残る	anc
appreciate	感謝する|高く評価する|鑑賞する|理解する	anc
upcoming	来るべき	anc
instructor	インストラクター	anc
echo	反響|おうむ返しに言う	original
exact	正確な|的確な|綿密な|を要求する|(税など)を搾り取る	anc
catholic	カトリック|普遍	wnjpn
destroy	を破壊する|を殺す|滅ぼす	anc
efficient	能率的な	anc
linear	線状に伸びる|線の|直線の|長さの|線形の	anc
jeans	ジーンズ	anc
chicken	鶏|ニワトリ|(俗)憶病者	anc
mention	について述べる|言及する|refer to	anc
rack	棚|枠|苦しめる|ちぎれ雲	anc
shadow	影|陰|ごくわずか|まねっこごっこ	anc
gap	裂け目|すき間|とぎれ	anc
narrow	(幅や面積が)狭い|狭くなる|狭い部分	original
scholarship	学問|学識|博学|奨学金	anc
sin	(主に宗教的な)罪(を犯す)|過失|ばかげたこと	anc
cabinet	キャビネット|飾り戸棚|箱|私室|閣議室|秘密の|(C-)内閣	anc
execution	制作|できばえ|実行|遂行|演奏|執行	anc
consent	同意する|承諾|同意|承諾する|黙諾|一致	anc
champion	支持する(stand up for)|のために戦う	anc
confidence	秘密|確信|信用|信頼|信任|自信	anc
pearl	真珠(の)|を真珠で飾る|真珠色	anc
avatar	権化|化身|具体化	anc
cry	(声をあげて)泣く	anc
difficulty	困難	anc
pee	(幼児語)おしっこをする|おしっこ	anc
monster	怪物|想像上の生き物で|人間や動物の様々な部位からできている	anc
drama	演劇|戯曲|脚本	anc
messenger	使者|使い走り	anc
eliminate	を削除する|を無視する|を排泄する|取り除く	anc
neither	もまた～ない	anc
championship	選手権	anc
rail	レール|横木|手すり|欄干|罵る|非難する|クイナ(鳥)	original
translate	言い換えられる|を翻訳する|を変える|を移す|を動かす|を訳す|を解釈する|を説明する	anc
micro	極端に小さい|顕微鏡でしか見えない|超ミニの|極小の|超ミニスカート	anc
offline	オフラインで	anc
consistent	不変の|矛盾のない|一致した|両立する|矛盾しない|首尾一貫した	anc
boundary	境|境界(線)	anc
bright	機転の利く|利口な|快活な|(色に関して)明るい|光る|晴れた	anc
gateway	入り口|門口|出入口|(成功などに至る)道	anc
mod	(服装など)流行の最先端をいく|大胆な|前衛的な	anc
prefer	をより好む	anc
babe	すっごい美人 (=dish)	anc
recognize	を識別する|を認める|だとわかる	anc
equation	均衡	anc
traveler	旅行者|旅客|外交員|移動販売員	original
objective	客観的な|事実に基づく|目的(の)|目的格の	anc
merchandise	商品|を商業化する|売買する|宣伝する	anc
laugh	笑う	anc
investigate	を調査する	anc
gray	青ざめた|灰色|青白さ|灰色の|白髪の|灰色の服	anc
formal	公式の|形の|正式の|形式的な	anc
classification	分類	anc
craft	クラフト|航空機|技術|手技	anc
journey	(通常陸上の, 比較的長い)旅行|(人生などの)行路|遍歴	original
dragon	竜	original
potter	陶工|焼き物師|陶芸家	anc
relation	関係	anc
recognition	認識|承認	anc
prayer	祈り|祈祷|請願|祈願|祈りの言葉|祈る人	anc
milk	牛乳|ミルク	anc
democratic	民主主義の|庶民的な|民主的な	anc
parameter	パラメーター|変数|媒介変数|母集団特性値|要素|要因|限界	anc
hockey	ホッケー	anc
segment	を分ける|弧|部分|線分|弓形|分節|体節	anc
belong	所属している|の所有物である	anc
cake	ケーキ	anc
ear	耳	anc
navy	(色)ネービーブルー|海軍|海軍力|海軍軍人	anc
lunch	昼食	anc
mile	1マイル(約1609m)|海里	original
heaven	至上の幸福|天国|天|神	anc
commissioner	コミッショナー|委員	anc
men	人手|稼働人口|人|マンパワー|人員|労働力人口|労働力|有効労働力|労働人口	wnjpn
universe	宇宙|万物|森羅万象	anc
jet	噴出|噴出物|噴出する|ジェット機で輸送する	booqs
decline	衰退する|低下する|辞退する|衰退|低下|(文法)格変化させる	anc
premier	首相|総理大臣|州知事|首位の|第一位の|最も古い|prime minister	anc
expansion	拡大|進展	anc
supreme	最高の|主権を有する|究極の|絶頂|至高の|最後の	anc
decade	10年間|10年	anc
rely	頼る|信頼する	anc
dose	(薬の)一服|投薬する	anc
wage	(戦いなど)を遂行する|を行う|賃金|給料|報い	anc
regulatory	規定する|取り締まる	anc
tend	する傾向がある|しがちである	anc
smooth	なめらかになる|ならす|円滑な|なめらかな|滑らかな|滑らかにする	anc
transaction	処理|取り扱い|取り引き|取引|報告書	anc
sensor	センサー(光･熱･音などに反応する感知器)	anc
pulse	パルス|脈|脈拍|鼓動|振動|波動|脈動|意向|脈打つ	anc
sand	砂|砂地|砂漠|砂色|に砂をまく|を磨く|に砂を混ぜる	anc
memorial	記念の|記念物|記録|追悼の	anc
venture	冒険(性)|危険|冒険的事業|投機|思惑|を危険にさらす|を賭ける|に敢然と望む	anc
scanner	走査装置	anc
fold	折りたたむ|折り重ねる|(腕･脚を)組む|抱く|包む|羊の群れ|信者	anc
subscriber	予約購読者|引受人|加入者|寄付する人|署名人|支持者	anc
ultra	過激な|極端な|過激(急進)論者	anc
continuous	絶え間ない|休みない	anc
disaster	天災|大災害|災難	anc
labour	働き	anc
spell	正しく書く|を綴る|後退|呪文|一続き(の期間)|期間	anc
occasion	出来事|場合|機会|業務|行事|根拠|用事	anc
dear	親愛なる	anc
mistake	誤り|間違える	anc
flood	おびただしい流入|洪水|氾濫する|大水|氾濫|にあふれる|に水を張る	anc
escape	逃げる|免れる|を避ける|逃亡|逃げ道	anc
truly	本当に|真実に|偽りなく|正直に|誠実に|忠実に|正確に	anc
extensive	広大な|大規模な|広範囲の	anc
affordable	手頃な価格の	anc
insight	洞察(力)|見抜く力|眼識	anc
settlement	保険金の支払い|解決|入植地|清算|定住|定着|和解	anc
char	炭にする|黒焦げにする	anc
arrive	到着する	anc
bang	バンと音を立てる|バタン|バーン|ドカン|ドアなどを閉める音	anc
outstanding	際だった|目立つ|未解決の|未払いの	anc
ha	おや|さあ|ほらね|まあ|エヘン|ハハ|haという声	anc
liberal	物惜しみしない|寛大な|自由主義者	anc
crisis	難局|危機|恐慌|分かれ目|重大局面	anc
sterling	英貨(の)	anc
blind	盲目の|無感覚の|行き場のない|理解できない|見えなくする|日除け|ブラインド	anc
tight	(関係などが)密接な|親密な|引き締った|堅い|水の漏れない|ぴんと張った|ぴったりした	anc
deck	デッキ|甲板	anc
contrast	対照|正反対のもの|対照させる	anc
constitution	体質|憲法|制定|構成|構造|組織|体格|気質|設立|形成|政体	anc
extract	を抜粋する|引抜く|栓を抜く|理論を推論する|聞き出す|煎じ出す|しぼり出す|(快楽を)見出す|抽出物	anc
receiver	受取人|収入役|会計係|接待者|受話器|受信機|容器	anc
finder	発見者|(カメラなどの)ファインダー|探知器	anc
illegal	非合法的な|不法の|違法の|非合法の	anc
modem	モデム|変復調装置	anc
tradition	正式の財産引渡し|伝統|しきたり|言い伝え|伝説	anc
retain	を実行しつづける|雇っておく|抱える|を保つ|保持する|持ちつづける|維持する	anc
crop	刈り込む|群れ|産出高	anc
simulation	シミュレーション|擬態|物まね	anc
rice	米|こめ	anc
animation	生気|活気|活発|動画|アニメーション	original
tomorrow	明日	anc
behalf	利益	anc
gourmet	料理や酒の味の鑑識力のある人|食通|グルメ|美食家	anc
republican	共和制の|共和政体の|共和国の|共和主義の	anc
democracy	民主主義	anc
imagine	想像する|を心に描く|を仮定する|を推測する	anc
ban	禁止する|禁止|prohibit	anc
reservation	予約|保留	anc
properly	適切に|適当に|礼儀正しく|立派に|正確に|相応に	anc
fundamental	基礎の	anc
grid	格子|鉄きゅう|グリッド	anc
newly	新たに|最近|再び	anc
fig	イチジク|取るに足らぬもの	anc
penalty	違約金|刑罰|罰金|罰|ペナルティ|罰則	anc
appearance	様子|出現|外観|状況|体裁|登場	anc
analyze	分析する|解析する|分解する	anc
downtown	下町	anc
occupation	仕事|従事|占有|居住	anc
cinema	映画館|映画	anc
restore	健康を取り戻す|返す|回復する|復興する|返還する|復元する	anc
castle	城	anc
belief	信じること|信用|信頼|信念|意見|信条	anc
celebrate	祝典をあげて祝う|祝う|祭典を挙行する|を公にする	anc
roof	てっぺん|屋上|最高部|天井|家|家庭	anc
romance	伝奇物語|空想小説|ロマンス|作り話|虚構|ロマンチックに考える|言い寄る|の歓心を買う	anc
motorcycle	オートバイ(和製英語)|バイク|単車で行く	anc
suitable	ふさわしい|適した	anc
absolutely	絶対的に|完全に	anc
modification	緩和|加減|修正|改良|変化|制限|変形|修飾	anc
cloud	雲	anc
arrival	到着	anc
tiger	トラ|乱暴者|強敵|狂暴な(残酷な)人|歓呼|喝采	anc
finding	発見|結論|(裁判官|陪審)認定|決定|裁定|結果|事実認定|付属品類	anc
bb	a small pellet fired from an air rifle or BB gun	wneng
registry	記載|登録|登録事項|登録所	anc
enemy	かたき|敵|敵国	anc
temporary	一時的な|はかない|仮の|当座の|臨時の	anc
tonight	今夜	anc
piano	ピアノ	anc
sir	あなた|あなたさま|拝啓|卿	anc
rush	急ぐ|突進|イグサ	anc
typical	典型的な|独特の|象徴的な|を象徴する|特有な	anc
intellectual	知的な|知識人	anc
yours	あなたのもの|あなたがたのもの	anc
dependent	依存している|扶養家族	anc
significantly	きわめて|意味深く|意味ありげに	anc
revolution	大改革|革命|循環|回転|旋回|公転	original
sufficient	十分な(量)	anc
murder	殺人|殺す|台なしにする|大きな警戒の叫び声	anc
fellow	匹敵者|男|奴|野郎|仲間|同輩|同僚	anc
refine	不純物を除く|純化する|精錬|製錬|精練|洗練する	original
hurricane	ハリケーン|あらし	anc
awareness	認識|意識性	anc
spyware	スパイウェア	anc
senator	上院議員	anc
communicate	知らせる|通信する|伝達する|伝える	anc
blank	白紙の|空虚な|白紙|無表情な	anc
smoke	煙草を吸う|煙|煙草をすう|一服|煙を出す|タバコを吸う|を吸う	anc
contribution	貢献|寄付	anc
resistance	電気抵抗|抵抗|反抗|抗争|反対|妨害|敵対|抵抗力	anc
phrase	言いまわし|言葉遣い|成句|熟語|慣用句|語法|句	anc
solar	太陽の	anc
wake	起きる|を起こす	anc
variation	変化|差異	anc
struggle	苦闘する|もがく|努力する|努力|苦闘	anc
reliable	たよりになる|頼りになる|信頼できる|当てになる|確実な|確かな|信頼し得る	anc
residence	邸宅|屋敷|住居|居住|安住|居留	anc
northwest	北西部の|北西へ|北西|北西地方	anc
unable	～できない|虚弱な|ひ弱な	anc
density	密集度|濃さ	anc
spectrum	範囲|領域|スペクトル|残像|幽霊	anc
biological	生物学(上)の|生物学的|生物学	anc
liberty	気まま|自由|解放|勝手|特権	anc
superior	より優れている|すぐれた	anc
sight	一覧払い|見ること|見えること|視力|名所	anc
dial	ダイヤル	anc
recall	を思い出す|を呼び戻す|召還(する)|撤回(する)|リコール	anc
reward	褒美|報奨|報酬|償い|謝礼|懸賞金|に報いる	anc
visitor	訪問者|見舞人|滞在客|観光客|(スポーツ)遠征軍	anc
plasma	プラズマ|血漿|リンパ漿|乳漿|原形質	anc
forth	前方へ|～以後|先へ|外部へ	anc
wow	ワーッ|感嘆の声	anc
anniversary	記念日|記念祭	anc
passenger	旅客|乗客|船客|足手まとい	anc
recipient	受取人|受容者|受賞者|受け取る|感受性のある	anc
tourist	観光客|旅行者	anc
metro	メトロ|地下鉄	anc
buffer	緩衝域|-を置く	anc
curve	カーブ|曲がる|曲線	anc
vector	ベクトル|方向量|保菌生物|病毒媒介昆虫(ハエ･カなど)	anc
reporter	報告者	anc
spiritual	精神的な|霊的な|崇高な	anc
magnetic	磁気の|磁性の|魅力ある|磁石の|魅力的な	anc
expenditure	支出(額)|出費|消費(量)	anc
instrument	手段|器具|法律文書	anc
stretch	を広げる|伸ばす|広がる|伸びる|広がり|期間	anc
bit	わずか|かんだ|ビット|小片|小銭|少量|少し|(俗)12セント半	anc
pregnant	妊娠している|意味深長な|含みのある|に満ちた(with)	anc
twice	2倍|2度|2回|2倍に	anc
photographer	写真家	anc
kg	キロ|キログラム	wnjpn
gi	ギルバート	wnjpn
crown	王にする|栄誉|王冠|(clownは別綴り)	anc
cellular	細胞の	anc
outlook	見通し|見解|見張り|見晴らし	anc
trace	の跡をたどる|追跡する|跡|足跡|痕跡	anc
attitude	態度|心構え|姿勢	anc
normally	普通に|順当に|標準的に|正常に|正規に|普段は	anc
charger	突撃する人(物)|乗馬|軍馬|充電器	anc
lo	見よ|そら	ejdict
explanation	説明	anc
refund	払戻し	anc
retailer	小売業者	anc
diabetes	糖尿病	anc
tissue	(動植物の細胞の)組織|織物|薄い織物	anc
meat	肉|食事|要点	anc
recorder	レコーダー|録音機	anc
compound	複合の|合成の|化合した|複合物|化合物|(成分など)を混合する|(文法)重文の	anc
incident	起こりやすい|ありがちな|出来事|事件(ささいに見えるが大きな外交問題に発展するような)	anc
satisfaction	満足|満足させるもの･こと	anc
container	容器|コンテナ|入れ物	anc
carbon	炭素(非金属元素)|元素記号C|カーボン紙	anc
flexible	まがりやすい|柔軟な	anc
numerous	おびただしい|非常に多くの|多数の	anc
relatively	比較的|相対的に	anc
mall	ショッピングセンター|散歩道|中央分離帯|商店街	anc
nick	ニック(人名)|刻み目|言い当てる|盗む|捕える|だます|刑務所	anc
infant	未成年者|幼児|赤子|幼少の|幼い	anc
completion	完了|完全さ	anc
float	浮くもの|浮かぶ|浮く	anc
shot	発射|弾丸|射手|shootの過去･過去分詞	anc
parallel	平行の|平行線|類似点|と平行する|と似ている	original
consolidation	整理|硬化|強化|合併	anc
bet	に賭ける|賭け|賭	anc
cosmetic	表面的な|化粧品	anc
preserve	を保つ|を維持する|を保護する|を保存する	anc
surf	波乗りする|サーフィンをする|波|寄せる波	anc
hook	ホック|かぎ|とめがね|かぎ形に曲げる	original
candle	ろうそく	anc
distributor	代理店|ディストリビューター	anc
pleasure	楽しみ|快楽|喜び|楽しいこと|好み	anc
comfortable	気持ちのよい|快適な|気楽な|慰めとなる|掛け布団	anc
exclude	を除外する	anc
effectively	有効に	anc
diary	日記	anc
stable	安定した|不変の|断固とした|しっかりした|馬屋	anc
massive	がっしりした|大きな塊になった|大きく見える|充実した|大きく重い|壮大な	anc
afternoon	午後	anc
pour	注ぐ|液体をつぐ|光を放射する|弾丸を浴びせる|殺到する	anc
layout	並べること|広げること|割り付け	anc
poverty	貧乏|貧困|不足|欠乏|欠如|貧弱	anc
counsel	に助言する|勧告する|助言|顧問弁護士|忠告	anc
establishment	設立|体制|でき上がったもの	anc
conversation	話し合い|会話|社交|交際|社交性|座談	anc
lay	横たえる|並べる|置く|位置|状態|横たわる|横になる	original
experimental	実験の|経験の|哲学の	anc
swing	揺れる(こと)|向きを変える|揺らす|動かす|回転|ぶらんこ|(野球)スイング(バットを振ること)	anc
receipt	受け取ること|レシート|受領|領収書|収益|受領書	anc
webcam	ウェブカメラ|webカメラ	wnjpn
rat	スト破り|裏切者|密告者|ノネズミ|ドブネズミ(mouseハツカネズミより大きい)	anc
mechanical	機械的な|機械の|メカニズム	anc
earnings	所得|利益|稼ぎ|生活力|儲け	anc
cooperation	協力	anc
slip	滑る|こっそり動く|はずれる|滑ること|ちょっとした間違い|細長い一片|伝票|挿し木	anc
collaboration	共同研究|共著|(占領国･敵国などへの)協力	anc
suffer	(いやなこと)を経験する|受ける|苦しむ	anc
interpretation	解釈|通訳	anc
jay	カケス|おしゃべり屋|まぬけ|マリファナたばこ	anc
knife	ナイフ|小刀|ナイフで刺す	anc
costume	の衣装を用意する|衣装	anc
formation	形成|編隊|～物|～体	anc
pioneer	開発者|開拓者|先駆者|パイオニア|を開拓する|先駆者となる	anc
toe	足指|あし指|つま先|蹄鉄の前部|先端	original
determination	決心|決定|判定	anc
cafe	喫茶店	anc
mineral	鉱物|鉱物の|無機物の|鉱物性の物質|無機化合物	anc
suspect	ではないかと疑う(suppose)|(人･もの)を疑う|容疑者|疑わしいもの	anc
concrete	コンクリート|凝結物|具象的な	anc
diversity	相違|多様性|多様化	anc
discipline	訓練する|規律|訓練	anc
pension	年金|に年金を与える	anc
adjustment	修正	anc
hairy	毛むくじゃらの|毛深い|毛製の	anc
captain	キャプテン|船長	anc
uniform	均一にする|一様な|同型の|そろいの|制服|軍服	anc
highlight	最も明るい部分|ハイライト|最も興味ある･重要な部分|呼び物|強調する|きわだたせる	anc
foster	養い育てる|育てる|助成する|育成する|よび起こす|心にいだく	anc
mask	マスク|仮面をかぶる|仮面|覆い隠すもの|仮面で覆う|隠す	anc
knight	騎士	anc
drill	ドリル|錐(きり)|ドリル(西アフリカ産のヒヒ)	anc
accessibility	接近可能性	anc
connector	連結者|コネクタ	anc
sensitive	敏感な|感じやすい|敏感に反応する|神経過敏の|感性豊かな	anc
spray	スプレーする|吹き掛ける|葉や花が付いた小枝	original
rob	盗む|強奪する|強盗をする|非難|叱責	anc
fiber	繊維(質･組織)|素質|気質|ひげ根(植物)	anc
massage	マッサージ|あんま|按摩術|もみ治療	anc
adoption	採用|養子縁組	anc
technique	方法|技術|技巧	anc
prison	刑務所|監獄|拘置所|監禁|禁固|幽閉	original
charity	慈善|思いやり	anc
leg	足	anc
dispute	議論|に異議をさしはさむ|論争する|反抗する|抵抗する|(言い)争う	anc
grey	灰色になる|灰色の	original
bold	ずうずうしい|大胆な|勇敢な|ずぶとい|奇抜な|顕著な|厚かましい	anc
bomb	爆撃する|爆弾	anc
grace	優雅|飾る|猶予(期間)	anc
specification	明細書|仕様|詳説|詳述|明細事項|仕様書	anc
thin	乏しい|か細い|弱々しい|を細くする|を薄める|細くなる|薄い|やせている|まばらな|希薄な	anc
garage	ガレージ|車庫	anc
accessible	近づきやすい|接近し易い	anc
accessory	アクセサリー|部品|付属物|装身具|補助的な|付属的な	anc
resident	居住する|居住者	anc
possibly	あるいは|ことによると|たぶん|どうにかして|出来る限り	anc
composition	構成|創作|作文	anc
typically	典型的に	anc
consumption	消費	anc
neck	頚状部|首|えり|いちゃつく	anc
busy	いそがしい	anc
franchise	フランチャイズ|特権|参政権|選挙権|公民権|会員権	anc
duration	持続|持続期間|所要時間	anc
ownership	所有権|所有	anc
cute	かわいい	anc
relax	規律を寛大にする|くつろがせえる|をゆるめる|の力を抜く|努力を控える|くつろぐ	anc
found	を設立する|findの過去･過去分詞形	anc
recover	回復する|取り戻す	anc
collector	光捕集器|収集家|集金人	anc
spin	を回転させる|一走り|を紡ぐ|を吐く|回転させること|落下|世論操作|情報操作|前向きにいい面を強調する	anc
consultant	コンサルタント|顧問|相談役	anc
lion	ライオン|名物男|人気者|勇敢な人	anc
routine	決まりきった仕事|日課|機械的なやり方|ルーチン	anc
lounge	ぶらぶらと時を過ごす|ぐったり横になる|ぶらぶらと歩く|長椅子|休憩所|談話室|ラウンジ	anc
reveal	を明らかにする|知らせる|示す	anc
escort	護衛する|護衛|付き添う	anc
legislative	立法権のある|立法の|立法機関(の)	anc
gang	囚人などの群れ|悪漢などの一団|遊び友達	anc
judgment	判断	anc
achievement	達成|業績	anc
temple	こめかみ|神殿|神殿･寺院|教会|殿堂	anc
willing	喜んでいる|快く|快くやる	anc
para	前に|…を経て|の意味|落下傘部隊の兵士|経産婦|ブラジルの地名 他	anc
molecular	(化)分子の	anc
invite	を招待する	anc
pharmaceutical	製薬の|薬剤の|薬	anc
seeker	探求者	anc
desert	砂漠|不毛の地|捨てる|放棄する|逃亡する|見捨てる|相応の報い|罰	anc
facilitate	容易にする|促進する|楽にする	anc
stereo	ステレオの|ステレオ(録音)方式|固定観念|立体写真	anc
sustainable	支えられる|持続可能な	anc
statistical	統計的な|統計(上)の|統計学の	anc
bankruptcy	倒産	anc
pipeline	パイプライン|流通ルート	anc
commentary	注釈書|注釈|注解書	anc
bulk	大部分|ばら荷|大半|大きいかさ|巨大な量	anc
favor	好意|親切|世話|恩恵|賛成する|を助ける|に好意を寄せる	anc
comply	(希望･要求などに)従う|応じる	anc
generator	発電機	anc
severe	厳しい|厳格な|能力(努力)を要する|きびしい|危険な	anc
mate	仲間|友達|連れ合い|片方|番わせる	anc
voltage	電圧	anc
lesson	授業|教訓(lessenは別語)	anc
asset	価値のあるもの|財産|利点|有用な|遺産|長所|資産の一項目	anc
ground	地面	anc
guardian	保護者|守護者|監視者|後見人	anc
handheld	片手で持てる|携帯できる	anc
humor	ユーモア|こっけい|機嫌|気性|の機嫌を取る|うまく合わせる	anc
semester	(米国･ドイツなどの1年2学期制の)学期	anc
stainless	ステンレス|奇麗な	anc
coordinator	コーディネーター	anc
deluxe	デラックスな|豪華な	anc
victory	勝利|克服|征服|(古ローマ)勝利の女神	anc
brochure	(営業用)パンフレット|小冊子	anc
tablet	平板|書き板|錠剤	anc
projector	映写機|投写機|企画者	anc
successfully	首尾よく|まんまと|具合よく|幸運にも	anc
bend	に取り組む|屈伏する|たわむ|曲げる|向ける|曲がり|屈曲|カーブ	anc
pursuant	に従う|準拠する|応じる	anc
valuable	貴重な	anc
recruitment	募集|採用	anc
primarily	主として|第一に|最初に	anc
recommendation	推薦(状)	anc
rubber	ゴムタイヤ|天性ゴム|弾性ゴム|紙やすり	anc
robot	ロボット	anc
amp	増幅器|アンプ|(ampere電流の単位|の略)	anc
cheese	チーズ|(俗)目的|報酬|お金|魅力のある若い女	anc
python	パイソン|大蛇|ニシキヘビ	anc
buffalo	野牛|水牛 2|(B-)バッファロー市(ニューヨーク州)	anc
quiet	静かな	anc
expensive	高価な	anc
terrorist	テロリスト(の)	anc
expertise	専門的技術|専門知識|専門的な意見	anc
survive	生き残る|より長生きする|を越えて生き延びる	anc
horror	恐ろしさ|恐怖|憎悪|嫌悪|ホラー映画	anc
detection	看破|探知|発見|発覚|検出	anc
pot	壷|はち|びん|植木鉢|壷に入れる|猟をする|撃つ|(俗)マリファナ	anc
rescue	救う|救出|救済|不法釈放	anc
optimization	最適化	anc
jewellery	宝石類	anc
welfare	福祉|厚生|幸福|社会事業|福祉補助を受けている	anc
eventually	結局のところ	anc
transform	変える|を変形する	anc
innovative	革新的な	anc
excess	超過|過剰|過剰な	anc
bracelet	腕輪	anc
tire	を疲れさせる|を飽き飽きさせる|タイヤ	anc
minority	未成年|少数|少数民族	anc
mat	マット|つや消しの|畳|靴ぬぐい|敷物|マットを敷く	anc
hurt	を傷つける	anc
ghost	幽霊|亡霊|二重映像|影	anc
era	年代|紀元|時代|段階	anc
joy	喜びの種|喜び	anc
tiny	極めて小さな|ちっぽけな|ちっちゃな|非常に小さい|小さな	anc
crowd	押しよせる|群集	anc
glance	ちらっと見ること|一瞥|きらめき|言及|ほのめかし|(弾丸の)はね返り	anc
encounter	に遭遇する|出会う|遭遇する	anc
compete	競争する|匹敵する	anc
inner	内部の	anc
dry	乾燥した|無味乾燥な|面白くない|退屈な|乾かす|辛口の(酒)|(俗)禁酒	anc
jr	ジュニア(Jr.)|二世	original
disclosure	暴露|発覚|発表|打ち明け話|明細|公開	anc
danger	危険	anc
calculation	勘定|計算|予測	anc
locate	位置する|ある|場所を見つける	anc
navigate	を航行する|(船･飛行機)を操縦する	anc
oracle	神託|神官|賢人	original
facial	美顔術|顔の|顔に用いる|美顔用の	anc
supervisor	指揮者|監督者|管理者	anc
rod	魔法の杖|棒(権力･支配力の象徴)|(俗)ピストル|釣り竿|ものさし|ロッド(単位)|桿状菌	original
clause	条項|個条|箇条|(文法)節	anc
forever	永久に	anc
fantastic	風変わりな|異様な|奇怪な|空想的な|気まぐれな|幻想的な	anc
proud	自尊心のある|誇る|誇りとする|光栄に思う|自慢している|高慢な|尊大な	anc
gross	グロース(12ダース･144個)|グロス|粗悪な|総計の|ひどい|でぶの|粗野な|総計	anc
boost	を押しあげる|上げる|強化する|後援する|値上げ|後援|尻押し|景気づけ|increase	anc
placement	置くこと|配置|職業紹介	anc
utilize	利用する|役立たせる	anc
operational	使用できる|操作上の	anc
handbook	手引き|便覧|旅行案内|賭金帳(競馬)	anc
cache	貯蔵所|貯蔵物|隠し場|隠してある貴重品	anc
par	同等|平価|標準|基準|パー|基準打数	anc
shoulder	肩|(道路の)路肩	original
vinyl	ビニール	anc
statute	法令|法規|規則|法|法律|成文律	anc
discharge	放電する|降ろす|放出(する)|開放(する)|解雇(する)	original
fetish	物神|呪物|迷信の対象|盲目的崇拝物	anc
intervention	市場介入|調停|仲裁|介入|干渉|内政干渉|売惜しみ	anc
blade	刃|(俗)ナイフ|羽根|タービン翼|(草の)葉	original
rep	代表(= representative)	anc
qualify	に資格を与える･得る|適格とする|限定する|修飾する	anc
aviation	航空術|航空学	anc
strap	縛る|固定する|を革ひもで縛る|吊皮|革ひも|つり革|革紐で縛る|ストラップ	anc
brush	ブラシをかける|かする|すれ合い|ブラシ|画法|小競合い|画筆|低木のしげみ	anc
subsection	小区分	anc
stack	積み重ね|スタック|堆積|干し草の山|を積み重ねる	anc
biz	ビジネス	anc
pine	松(の木)|思い焦がれる|やつれる	anc
defendant	被告(人|側の)|民事訴訟の被告	anc
ridge	山の背|に棟をつける|棟|尾根|背筋|うね|畝	anc
usual	いつもの|通例の|普通の	anc
shore	海岸|(船体･建物などの)支柱|を支える|を支援する	anc
nail	(人間の)爪タバコ|殴る|逮捕する	anc
blackjack	ブラックジャック	anc
valve	バルブ|弁|水門の戸|真空管|弁で調節する	anc
ongoing	継続中の|(現在)進行中の|現行の|発達中の	anc
publish	出版する|を発表する	anc
ill	病気で|悪く|不親切に|不幸な|悪|不運	anc
reliability	信頼|頼もしさ|信頼性|信憑性|確度|確実	anc
devil	悪魔(=daemon, Satan, fiend)	original
dangerous	危険な	anc
citation	引用	anc
mad	怒った	booqs
alter	を変更する|変わる	anc
divorce	と離婚する|離婚	anc
unfortunately	あいにく|不幸にも|不運にも	anc
grill	(n)格子|焼き網|(v)焼く|厳しく尋問する|難題で苦しめる	anc
respectively	それぞれに|それぞれ|個々に	anc
motel	モーテル(Motor Hotel)	anc
parliament	議会|国会|英国議会	anc
dad	お父さん|パパ	anc
blend	混ぜ合わせる|混ざる|混合	anc
semi	セミトレーラー|二軒連棟の家|セミコロン|セミファイナル	anc
luck	運|幸運	anc
beast	けだもの|獣|畜生|動物|牛馬|家畜|獣のようなやつ|人でなし	anc
postage	郵送料金|郵便料金|郵税|とても狭い場所	anc
ward	かわす|撃退する|(選挙などの)区|被保護者|保護|監房|病棟|中庭|(カギの)刻み目|突起	anc
till	まで	anc
undergraduate	大学生	anc
engage	に従事する|参加する|を行う|従事させる	anc
productivity	生産性|生産力	anc
comic	喜劇の|こっけいな|マンガ(の)|漫画	anc
assure	確実にする|保証する|安心させる|被保険者	anc
underground	反体制の|地下の|秘密の|(UK英)地下鉄|(米)地下道	anc
carefully	注意深く	anc
shoe	くつ|靴	anc
fault	過失|誤り|欠点|過ち|責任|断層	anc
pace	歩み|一歩|歩調|速度|歩幅|歩き方|(を)ゆっくり歩く|歩調を整えて歩く	anc
deadline	期限|締切	anc
diagnosis	診断	anc
principle	原理|主義|原則|公理|方針|信条|道義|本質|本源	anc
talent	才能|天分|素質|手腕	anc
globe	地球儀|球体|天球|球|地球	anc
digest	(食物を)消化する|要約する|知識を会得する|要約|摘要	anc
probe	徹底的な調査|査察(=investigation他)|探り針|試験|探る|厳密に調査する	original
differ	異なる	anc
combat	と戦う|戦う|論戦|と闘う	anc
tall	高い	anc
grove	木立ち果樹園|小森|林	anc
sleeve	そで|袖|スリーブ|レコードのジャケット|にそでを付ける	anc
assess	評価する|査定する|課する|評定する	anc
weak	弱い	anc
vessel	容器|大型の船|飛行機|体内の管|導管	anc
reviewer	批評家|評論家	anc
brake	ブレーキ|歯止め|制動機|(植物)シダ|ワラビ	anc
adopt	採用する|養子にする	anc
apart	ばらばらに|区別して|離れて	anc
workplace	職場	anc
tan	なめす|皮をなめす|皮膚を日焼けさせる|タンニン|黄褐色	anc
cottage	別荘|小屋	anc
prompt	を促す|駆り立てる|すばやい|即座の	anc
illustration	説明図|挿絵|実例|例図|図解|例証|イラスト	anc
familiar	よく知られている|聞き慣れた|見慣れた|普通の|精通している|気楽な|親しい	anc
vertical	垂直な|垂直の|鉛直の|頂上の|天頂の	anc
bean	豆	anc
dirty	きたない|汚れる|不潔な	anc
refinance	借り換える	anc
strongly	頑丈に|強く	anc
absolute	絶対の|確実な|絶対的な	anc
bidder	入札者	anc
wolf	狼|オオカミ|貧欲な人|女たらし|がつがつ食べる	anc
capable	手腕のある|能力のある|有能な|ができる	anc
fluid	変りやすい|流動性の|流体(の)|流動体	anc
substitute	代用する|代用の|代用になる|代理人|代用品	anc
ethnic	民族の|人種の	anc
referral	委託|照会|紹介|推薦された人|委託された人	anc
pat	適切な|すっかり|軽くたたく(こと)|なでること|軽くたたく音	anc
walker	散歩する人|歩く人|歩行器|歩く鳥	anc
summit	首脳(陣)|山頂|頂点|首脳会談|首脳レベルの	anc
stroke	をなでる|ストローク|一撃|打撃|発作|(脳)卒中|一回の動作|(ペン･筆などの)一筆	original
scenario	シナリオ	anc
terrorism	テロ行為|恐怖政治	anc
progressive	進歩的な|進行する|漸進的な|連続的な|発展する|進行形の	anc
mainly	主に|主として	anc
trap	わなに掛ける|罠を仕掛ける|わな|落とし穴|監視所|トラップ|防臭弁	anc
sick	病気の	anc
sink	台所の流し|沈む|落ち込む|衰える|減る|染み込む|を沈める|流し	anc
municipal	市の|内政の|局地的な|地方自治の|市営の	anc
jurisdiction	支配権|司法権|管轄権	anc
indoor	屋内|室内の	anc
integrate	統合する	anc
citizen	市民|国民	anc
skirt	スカート|すそ|郊外|囲む	anc
acknowledge	白状する|感謝する|認める|承認する	anc
structural	構造(上)の	anc
tough	強靭な|丈夫な|折れない|強い|堅い|頑丈な|困難な|凶悪な|タフ	anc
telecom	電気通信	anc
anytime	いつでも	anc
warehouse	を倉庫に入れる|を保税倉庫に預ける|商品保管所|卸売り店|問屋|倉庫|大商店	anc
portrait	ポートレート|肖像画|似顔絵	anc
pound	ポンド|16 ounce|453|6g|100 pence|(駐車違反車の)留め置き場|(馬の)囲い|ドンドン打つ|つき砕く	anc
planner	立案者|プランナー	anc
twist	をねじる|を曲げる|を縫っていく|よじれ|より糸	original
attract	(人･注意)を引きつける|魅惑する	anc
trim	刈込む|整備(する)|削減する|を装飾する|(身体の)調子|気分|きちんとした	anc
hunt	捜索する|捜す|追う|探求(する)|狩る|狩猟(する)	anc
ease	慎重に動かす|そっと位置を移す|楽にする|安楽|軽減|気楽|容易	anc
trend	トレンド|流行|傾く|風潮|傾向|趨勢|方向|向く	anc
dust	埃を払う|ほこり|粉末|地面|灰|遺骨|(俗)お金|コカイン	anc
tropical	熱帯の|熱帯性の|非常に暑い|猛暑の|回帰線の	anc
worker	労働者|肉体労働者|仕事をする人|研究者|働きバチ|勉強する人	anc
purple	紫色|紫衣|枢機卿や司教の地位|王侯貴族の地位|王位|紫色の|帝王の|華麗な|美文調の	anc
alive	生きている	anc
assumption	仮定|引き受け	anc
singer	歌手	anc
automobile	自動車	anc
vocal	ボーカル|声の|口頭の|声楽の|有声音|母音|声楽	anc
strengthen	強くする(なる)	anc
arcade	アーケード	anc
mph	マイル毎時	original
existence	生存物|現存|実存|存在|実在|生活	anc
baker	パン屋|携帯用小型天火	anc
mayor	市長	anc
syntax	シンタックス|統語論|構文	anc
socket	ソケット|受口|受け口|を受け口(ソケット)にはめ込む	anc
ceo	最高執行責任者	wnjpn
antenna	アンテナ|空中線|antennae(antennaの複数形)(æntɛ́ni)(動物の)触角|触毛	anc
nationwide	全国的な(に)	anc
definitely	きっぱりと|(強い肯定･同意)確かに|全く(そのとおり)	anc
wizard	名人|魔法の|魔法使い(男)|魔術師	anc
immigration	(外国からの)移住|入国(者)	anc
mutual	互いの|お互いの|相互の|共通の	anc
hack	たたき切る|刻み目|(報酬目当ての)雇われ専門家	anc
sierra	連山|山脈	anc
quest	探求|探索|クエスト|を探索する	anc
habitat	生息地|環境|居住環境|生育地|すみか|居住地	anc
fraud	詐欺(行為)|欺瞞|ごまかし|詐欺師	anc
necessarily	必然的に|必ず	anc
depression	不況|不景気|不振|下降|沈下|陥没|低地|俯角|鬱病|うつ状態	anc
architect	建築士|建築家|設計者|建設者	anc
everyday	毎日の	anc
projection	投影|発射|射出|投射	anc
apparently	明らかに|見たところでは	anc
popularity	人気|評判|大衆性	anc
dozen	1ダース|12個|(複数で)多数	anc
satisfy	(欲望･必要･好奇心)を満たす|(人)を満足させる	anc
headset	ヘッドセット|マイク付きヘッドホン	anc
absence	留守|欠席|欠乏	anc
firewall	ファイアウォール	anc
interval	隔たり|間隔|合間|距離|幕間	anc
visible	明白な|目に見える|明らかな|今手元にある	anc
solo	ソロ|独唱(独奏)の|独奏(曲)|独唱(曲)	anc
sue	を訴える|訴訟を起こす|請う|告訴する	anc
invest	人に着せる|に投資する|金を使う|を覆う|取り巻く	anc
obviously	明らかに|目立って	anc
moderate	控えめの|節度のある|穏健な|適度の|やわらげる|司会をする|穏健派	anc
mercury	水銀	booqs
perfume	におい|香り|香水|に香水をつける|を芳香で満たす	anc
arise	現れる|(問題など)が生じる	anc
privilege	特権を与える|特権|特典|特別扱い|基本的人権|恩恵|特恵	anc
reproduction	複製品|複製|模写|再版|生殖|再現|再生|再演	anc
shake	を振る|震える|を動揺させる	anc
excerpt	(本などからの)引用(句)|抜粋|抄録|抜粋する	anc
radar	レーダー|電波探知機	anc
beam	梁|輝き|発散する|送る(放送する)|顔を輝かせる	anc
palace	宮殿|大邸宅|宮廷の有力者達	anc
organize	組織化する|団結する|組織する|計画する|体系づける	anc
somewhat	いくぶんか|幾分	anc
emphasis	強調|重要性	anc
substantial	しっかりした|実質的な|重要な|実体のある|相当な	anc
enhancement	強化	anc
impossible	不可能な	anc
arena	競技場|土俵|闘争の場|闘技場|試合場	anc
dodge	さっと身をかわす|かわす|はぐらかす	anc
vacuum	真空地帯|真空の|掃除機で掃除する	anc
stem	幹|茎|葉柄|(～の流れを)止める･止まる|(時流など)に抵抗する|由来する|語幹	anc
obvious	明らかな|露骨な|明かな|わかりきった	anc
inter	(死体を)埋める|埋葬する|葬る(bury)	anc
pottery	陶器	anc
okay	OK|大丈夫	anc
slave	あくせく働く|奴隷|捕われている人	anc
platinum	プラチナ(色･金属元素)	anc
watt	ワット(電力･工率の単位)	anc
illness	不健康|病気	anc
inform	知らせる	anc
atmosphere	雰囲気|環境|空気|気圧|媒体ガス|触媒|大気	anc
carpet	じゅうたんを敷く|じゅうたん	anc
jam	混雑|ジャム|妨害する|詰め込む	anc
alternate	かわるがわる|互い違いの	anc
tee	はじめる|の準備をする|ティー|T	anc
memorabilia	記憶すべきこと･もの	anc
pitch	ピッチ|程度|投げる|(テントを)張る	anc
shield	かばう|シールド|盾|防御物|を保護する	anc
strain	傾向|素質|話し(書き)ぶり|旋律|気質|緊張させる|ぴんと張る|痛める	original
behaviour	行動	anc
trainer	訓練者|コーチ|指導者|練習機	anc
electricity	電気学|電気(学)|気学|電流|電力	anc
compilation	編集|編集物|寄せ集め	anc
thick	厚い|分厚い|混雑している|濃い|深い|鈍い|太い部分|賑やかなところ|(方言などが)明瞭にわかる	anc
flame	光彩|炎|情熱|火炎|光輝|激情	anc
roger	了解|よろしい	anc
declaration	宣言|通知|申告	anc
aspect	面|様子|外観|性状|顔つき|姿|(文法)動詞の相|アスペクト	anc
awesome	すごい|とてもいい	anc
pizza	ピザ(パイ)	anc
screw	ねじくぎ|木ネジ|スクリュー|らせん状のもの|苦しめる|痛めつける|をねじ釘で取り付ける	anc
candy	キャンデー	anc
federation	連邦|連盟|連邦政府|同盟|組合|連合	anc
hist	シーッ|静かに|静まる|シーと言って追い立てる	anc
consult	に助言を求める|意見を聞く|に相談する|を参考にする|を調べる	anc
torture	を拷問にかける|苦しめる|ねじる|拷問|苦痛|歪曲	anc
passion	激情|熱情|感情|熱中	anc
tile	タイル|かわら|化粧タイル|牌	anc
prospect	予想|候補者|見晴らし|観察|を調査する	anc
advocate	弁護する|擁護する|主張する|弁護士|支持者|運動家	anc
involvement	関わり|巻き込むこと	anc
incorporate	を具体化する|法人組織にする|合併する|組込む|受け入れる	anc
chest	収納箱|胸郭|金庫|たんす|肺	anc
pursue	を追求する|追う|を続ける|実行する	anc
shoot	を撃つ|を射る|シュート(する)	anc