whip	を鞭で打つ(こと)|を激しく打つ|打負かす|励ます|急に動かす|あわだたせる|猟犬係|ホイップ	anc
hormone	ホルモン	anc
plasma	プラズマ|血漿|リンパ漿|乳漿|原形質	anc
objection	反対|難点|欠点|不服	anc
bath	浴槽|入浴	anc
proceeding	行為|仕方|行動|処置|進行状態|議事録	anc
instinct	本能	anc
bloody	血なまぐさい|ひどく	anc
ministry	内閣|省|大臣の職務|奉仕|聖職者	anc
thesis	論文|主張|議題|論題|題目|卒業論文|命題	anc
practically	実用的に|事実上|事実上は|実質的に|実際に用いて|ほとんど	anc
productive	生産的な|生産力のある|豊富な|多産な|を生じる	anc
partially	部分的に|一部分|不十分に|不公平に|一部分は|っ部分的に	anc
exclude	を除外する	anc
throne	王座|王位|司教座|国王|皇帝	anc
dive	飛び込む	anc
chip	チップ|情報	anc
halt	停止させる|ためらう|停止|休止|中断|停車場	anc
concentrate	集中する|集中させる	anc
horizontal	地平線の|水平の	original
strive	努力する|戦う	anc
fleet	速い|艦隊|海軍|入江	anc
mild	温和な|温暖な|穏やかな|柔らかな|やさしい|軽い	anc
nest	に巣をつくってやる|巣|巣を造る|隠れ場所|悪事の温床	anc
birthday	誕生日	anc
purple	紫色|紫衣|枢機卿や司教の地位|王侯貴族の地位|王位|紫色の|帝王の|華麗な|美文調の	anc
quantum	量子	original
rid	を自由にする|免れさせる|を取り除く|を駆逐する	anc
automatically	自動的に	anc
mighty	大きい|非常に|力強い|強力な|巨大な|並外れた|膨大な|重大な|多量の	anc
derive	由来する|派生する|引き出す	anc
scarcely	ほとんど～ない|とても～ない|辛うじて	anc
bark	howl遠ぼえする|whineクンクンなく|yelp|yapキャンキャン吠える|growl怒って唸る|snarl歯をむき出して唸る)|樹皮	anc
faithful	義務を遂行する|忠実な|誠実な|信頼できる|貞節な	anc
sketch	スケッチする|スケッチ|草案|概略	anc
patent	専売特許の|特許(権)|特許の|の特許権をとる	anc
thickness	厚さ|厚いこと|密集|密生|繁茂|頻繁	anc
hybrid	混成語|雑種|合いの子|ハイブリッド|混成物	anc
miracle	奇跡|奇跡的な出来事	anc
qualitative	質的な|定性的な|性質上の	anc
cotton	綿織物|綿	anc
remedy	を治療する|医療|治療|療法|医薬|救済策	anc
finite	限定された|限りある|有限の	anc
tense	強くはった|緊張した|張り詰めた|堅苦しい|ぴんと張った|時制	anc
bore	うんざりさせる|退屈なもの(人)|bear(産む)の過去形|掘る	original
resort	助けを借りる|手段を使う|行く|通う|頼る|盛り場|保養地|行楽地	anc
anchor	錨|しんがり|定着させる|固定させる	anc
observer	オブザーバー|観察者|観測者|遵守者|立会人	anc
flexible	まがりやすい|柔軟な	anc
exploration	探検|探求	anc
pole	棒|柱|マスト|ポール|(性格･言動などの)正反対|両極端	anc
spine	脊椎|脊柱|背骨|針|とげ	anc
sip	すする|(飲み物の)一口|(～を)少しずつ飲む	anc
quantitative	定量的な|量ではかれる|量に関する	anc
doorway	戸口	anc
seemingly	一見したところ|うわべは	anc
nowhere	どこにも～ない|どこにもない場所	anc
shortly	間もなく|まもなく|手短に|簡単に|ぶっきらぼうに	anc
celebrate	祝典をあげて祝う|祝う|祭典を挙行する|を公にする	anc
informal	正式でない|非公式の|略式の|変則の	anc
beneficial	ためになる|有益な	anc
magnitude	重要さ|重要性|大きさ|大きいこと|(天体)光度|等級|マグニチュード	anc
trunk	トランク|主要な|(木の)幹･胴体|幹線|長距離電話|(象の)鼻	anc
citizen	市民|国民	anc
disadvantage	不都合|不利|不便|損害	anc
actively	活発に	anc
deviation	本筋からはずれること|方針からの逸脱|偏り|偏差|脱線	anc
writing	書く|執筆|筆跡|書くこと|書かれた物|書き方	anc
football	フットボール(ラグビーやサッカーの総称)	anc
bubble	泡(立てる･立つ)|実態のないもの|みせかけ	original
actor	俳優	anc
brick	れんがを敷く|れんが	anc
expose	さらす|をあばく	anc
therapist	療法士	anc
analytical	分解の|分析的な|解剖的な	anc
warmth	思いやり|暖かさ|熱心	anc
invisible	目に見えない|目にみえない|目につかない	anc
belly	腹|食欲|胃|腹部|ふくらます	anc
corruption	腐敗|不正行為|汚職|賄賂|買収	anc
substrate	基板|(生化学)基質(酵素の作用で化学反応を起こす物質)	anc
toy	おもちゃ|おもちゃの|つまらぬもの|もてあそぶ|いいかげんに扱う	anc
elderly	中年を過ぎた|初老の|年配の|時代遅れの|年配|老齢	anc
mysterious	神秘的な|不可解な|秘密の	anc
portrait	ポートレート|肖像画|似顔絵	anc
penalty	違約金|刑罰|罰金|罰|ペナルティ|罰則	anc
economics	経済学	anc
adverse	不利な|反対の	anc
intelligent	知的な	anc
silk	絹(の衣服)|絹の|やわらかな|ぜいたくな|絹糸|絹織物|(複数形で)絹の着物|(競馬の騎手の)制服	anc
strand	座礁する(させる)|岸に上がる|立ち往生する|取り残す(される)|より糸|房	anc
consensus	意見一致|一致|総意|全員一致	anc
dependence	依存|従属	anc
conscience	良心|誠実さ	anc
adapt	を適応させる|慣れさせる|適応する|を改変する	anc
invitation	招待状|招き|招待|案内|案内状	anc
statue	像|彫像|塑像	anc
probe	徹底的な調査|査察(=investigation他)|探り針|試験|探る|厳密に調査する	original
emergence	出現	anc
accomplish	を成し遂げる|完成する|成就する|実行する	anc
civilian	一般市民の|一般人|文民の	anc
warrant	正当な理由となる|を保証する|に請け合う|令状|証明書	anc
pig	ブタ(swineより家畜的な意味)|豚肉|ブタのようなやつ|あばずれ女|金属塊|子を生む	anc
fulfill	遂行する|fulfill(米語)|fulfil(英)	anc
subtle	かすかな|難解な|微妙な|繊細な|敏感な|陰険な|薄い	anc
twist	をねじる|を曲げる|を縫っていく|よじれ|より糸	original
shiver	震える|震え	anc
ton	トン|多量|多数|非常な重さ|流行	anc
hunt	捜索する|捜す|追う|探求(する)|狩る|狩猟(する)	anc
sampling	サンプリング抽出	anc
symbolic	象徴主義の|象徴的な|記号による	anc
controlling	制御	anc
commodity	生活必需品|商品|必需品|日用品|有用品|物資	anc
wealthy	富んでいる|裕福な	anc
sustainability	持続可能性	anc
genius	(非凡な)才能|天才|特質	anc
verify	証明する|が本当であることを証明する|を立証する	anc
specify	明白に記す|記入する|を明細に述べる|を指定する|を明細書に記入する	anc
deficiency	不足|欠乏|欠陥|lack|insufficiency	anc
efficacy	効き目|効果|有効性	anc
inherent	本来備わっている|生来の|生得の|固有の|先天的の	anc
maid	少女|お手伝い|女中	anc
romantic	ロマンテックな人|伝奇物語的な|ロマンチックな|実際的でない|非現実的な	anc
protective	保護の|保護用の	anc
reception	receiveの名詞形|歓迎会|披露宴|聴取|応接|入会	anc
invasion	侵入	anc
passive	消極的な|受動的な|活動的でない|無抵抗の|受動態の	anc
civilization	文明|文化|教化	anc
operational	使用できる|操作上の	anc
extraction	摘出	anc
copper	(軽蔑的に)警官|銅|銅板|銅器|銅製品|銅貨	anc
oxide	酸化物	anc
corridor	廊下	anc
cheer	声援|を励ます	anc
awful	すざましい|すさまじい|恐ろしい	anc
undermine	密かに傷つける|の下を掘る	anc
metric	メートルの|メートル法の|測定基準|距離関数|韻律学	anc
generous	気前の良い|気前のいい|豊富な	anc
repeatedly	繰り返して|再三再四	anc
diagnostic	診断の	anc
bold	ずうずうしい|大胆な|勇敢な|ずぶとい|奇抜な|顕著な|厚かましい	anc
excessive	過度の|必要以上の	anc
tourism	観光事業|観光旅行	anc
fatigue	疲労|疲労する	anc
rifle	ライフル銃	anc
absorption	吸収|吸着|吸着量	anc
scholarship	学問|学識|博学|奨学金	anc
correctly	正しく	anc
entertain	もてなす|楽しませる|楽します	anc
injection	注射	anc
photograph	写真|を写真にとる	anc
cruel	悲惨な|残酷な	anc
terminal	死に至る|終末の|終点|ターミナル|3端末|端子	anc
imply	を(暗に)意味する|ほのめかす	anc
cord	コード|紐	original
estimation	見積|評価|判断	anc
candle	ろうそく	anc
sofa	ソファー	anc
optical	光学上の|眼の	anc
ambition	功名心|大望|大きな望み	anc
accessible	近づきやすい|接近し易い	anc
purely	純粋に|混じり気なく|単に|全く|きれいに	anc
dull	苦痛を和らげる|(切れ味や頭が)鈍い|わかりの遅い|鈍感な|動作がのろい	anc
complain	苦情を言う|不満を言う	anc
competence	能力|権限	anc
deficit	欠損|不足|赤字	anc
exclusive	排他的な|専門的な	anc
illegal	非合法的な|不法の|違法の|非合法の	anc
salvation	救世(主)|救済|魂の救済|救済物|(罪からの)救い	anc
robe	職服を着る|ローブ(長くてゆったりした外衣)|バスローブ|式服|礼服|職服|浴衣|化粧着|衣服	anc
semi	セミトレーラー|二軒連棟の家|セミコロン|セミファイナル	anc
loyalty	貞節|忠義|忠誠|誠実	anc
whilst	一方(=while)	original
translate	言い換えられる|を翻訳する|を変える|を移す|を動かす|を訳す|を解釈する|を説明する	anc
peculiar	奇妙な|特有の|特別の|特権|私有財産|義務|義理|債務|債券	anc
solely	ひとりだけ|ただ一人で|たんに	anc
replacement	取り替え|代用品	anc
dense	密集した|濃密な|深い|鈍い|濃厚な|緻密な|濃い	anc
validity	有効期間|正当性|妥当性|有効性|効力|有効|合法性	anc
similarly	同様に|類似して|同じく	anc
bush	やぶ|草むら	original
hydrogen	水素	original
workshop	職場|仕事場|作業場|研修会|講習会|工場	anc
pollution	公害|汚すこと|汚染|汚れ	anc
submit	を服従(屈服)させる|を提出する	anc
comply	(希望･要求などに)従う|応じる	anc
realised	実現した	anc
uncertain	変りやすい|不確実な|疑わしい|しっかりしない	anc
clue	手がかり|筋道|かぎ|手掛かり|糸口|端緒	anc
cough	咳をする|せき|咳	anc
funeral	葬儀|葬式(の)|葬列|告別式	anc
artistic	美術家の|芸術的な|風雅な	anc
inevitable	避けられない|不可避の	anc
bunch	仲間|一団|群|(果物などの)房	anc
donor	寄贈者|臓器提供者|開発援助供与国	anc
intermediate	中間にある|中間の|媒介物|仲裁人|中間体	anc
signature	署名	anc
feminist	男女同権主義者|男女同権主義	anc
isolation	遊離|孤立|孤独|分離|隔離	anc
rival	商売がたき|競争者|対抗者|ライバル|対抗する	anc
static	静止した|空電|静的な	anc
tolerance	寛容|寛大|容認	anc
purse	すぼめる|富|財布|がま口|ハンドバック|金|資金	anc
clarify	明らかにする|ハッキリさせる	anc
tract	広がり|広い地面|地方|地域|小論文|小冊子|パンフレット(特に宗教関係の)	anc
anybody	だれでも|全ての人|誰か	anc
honey	はちみつ	anc
fierce	気性が荒々しい|激しい|すさまじい|獰猛な|熱烈な	anc
chocolate	チョコレート	anc
furniture	必要備品|(集合的に用いて)家具|備品|建具	anc
scar	傷跡になる|そこなう|傷跡|心の傷跡	anc
swallow	を飲み込む|納得して受け入れる|ツバメ	anc
revelation	(キリスト教)啓示|黙示|お告げ|暴露|発覚|新発見	anc
projection	投影|発射|射出|投射	anc
peaceful	平和な|穏やかな|平和を好む|おとなしい	anc
subjective	主体の|主観の|主観的な|主格の|主語の	anc
bay	吠えつく|(猟犬の)ほえ声|窮地|月桂樹|栄光|湾|入江(gulfとcoveの中間)|くり毛の(馬)|支柱間の壁|仕切り部分	anc
verbal	言葉の|語の|文字通りの|口頭の|動詞の	anc
humble	つつましやかな|身分の低い|謙虚な|卑しい|地位が低い|質素な	anc
utilize	利用する|役立たせる	anc
optimization	最適化	anc
flour	小麦粉|粉末	anc
studio	スタジオ|仕事場	anc
disgust	に嫌気を起させる|嫌にならせる|嫌悪感|嫌悪	anc
pussy	ネコ|毛のある柔らかいもの	anc
width	幅|広さ	anc
pet	ペット|ペットボトル	original
manual	マニュアル|手の|手動の|小冊子|便覧	anc
penetrate	を貫通する|染み込む|入る|理解できる|仮釈放(する)|執行猶予|合い言葉	anc
dirt	ごみ|ほこり|うわさ話|スキャンダル|無価値なもの→うわさ話	anc
drill	ドリル|錐(きり)|ドリル(西アフリカ産のヒヒ)	anc
designer	デザイナー|設計者	anc
enthusiasm	熱中させるもの|熱中|意気込み|熱狂	anc
upstairs	二階へ|階上へ|より高い地位へ	anc
vulnerability	傷つきやすいこと|脆弱性	anc
likelihood	ありそうなこと|見込み|有望さ|有りそうな事	anc
arrange	手はずを整える|手配する|を配列する|整理する	anc
posterior	後ろの|尾部の|後部の|後の|次の	anc
safely	無事|安全に|無事に	anc
campus	キャンパス|校庭	anc
diabetes	糖尿病	anc
marine	海の|船舶の|海軍の|海事|海兵隊員	anc
steer	舵を取る|操縦する|を案内する|向ける|進む|雄の子牛|去勢した雄牛	anc
conservation	保存|保護|維持|国家管理	anc
insult	侮辱する|侮辱	anc
menu	メニュー|献立表|料理	anc
spy	ひそかに調査する|密かに見張る|スパイ	anc
assure	確実にする|保証する|安心させる|被保険者	anc
supplement	補足|追加|補遺|補角|を補う	anc
query	疑問をはさむ|を疑う|を問う|疑問|疑い|質問	anc
minimal	最小の|最小	anc
salary	棒給|給料|サラリー	anc
inferior	下の方の|より下の|下位の|下級の|劣った|粗悪な	anc
mathematics	数学|計算|数学の|全く厳密な	anc
weird	超自然的な|奇妙な|風変わりな|変な|不思議な|運命の	anc
kindness	親切な行為|親切心	anc
meaning	意味する|意味|意義|真意|効果|意味深長な	anc
attraction	魅力|引きつけるもの	anc
prize	賞|賞品	anc
basket	かご	anc
quit	をやめる|give up|stop	anc
prejudice	先入観|害|偏見|先入主|偏愛|ひがみ|損害|被害|迷惑	anc
sleeve	そで|袖|スリーブ|レコードのジャケット|にそでを付ける	anc
harsh	厳しい|ざらざらした|不快な|耳ざわりな	anc
glimpse	ちらりと見えること|一瞥(いちべつ)|ちらりと見る	anc
lifestyle	生活様式	anc
alike	差別なく|同様に|一様に	anc
valve	バルブ|弁|水門の戸|真空管|弁で調節する	anc
indirect	間接の|遠回しの|曲がった|不正な|遠回りの	anc
literacy	教育のあること|読み書き能力	anc
corn	トウモロコシ|穀粒|穀草|魚の目	anc
screw	ねじくぎ|木ネジ|スクリュー|らせん状のもの|苦しめる|痛めつける|をねじ釘で取り付ける	anc
displacement	置換え	anc
boil	煮えくり返る|沸騰する|ゆでる|沸く|煮沸する	anc
cable	有線テレビ|ケーブル	anc
swing	揺れる(こと)|向きを変える|揺らす|動かす|回転|ぶらんこ|(野球)スイング(バットを振ること)	anc
bulk	大部分|ばら荷|大半|大きいかさ|巨大な量	anc
spark	火花を出す|スパーク|火花(を散らす)	anc
useless	役に立たない|無用な|無駄な	anc
justification	正当化	anc
ecological	生態学の|生態学上の	anc
handling	取り扱い|ハンドリング|扱うこと|出荷|操作|手綱捌き	anc
copyright	著作権|版権	anc
keen	しみじみとした|鋭い|鋭敏な|熱心な	anc
ash	灰|トネリコ(材)	anc
dollar	ドル	anc
recipe	調理法|製法|処方箋|方策|手段	anc
ideological	イデオロギーの	anc
buyer	買い手	anc
systemic	組織の|全身(性)の	anc
beloved	最愛の	anc
fake	ごまかし|いかさま|のふりをする|仮病を使う|ねつ造する|だます	original
airport	空港	anc
reporter	報告者	anc
breed	(動物が子を)産む|(鳥が卵を)かえす|(人を)養育する(up)	anc
demonstration	デモ|実証|実演	anc
exclusively	もっぱら|排他的に|一途に|専ら	anc
hip	しり|センスのある|流行最先端の|臀部|腰|賢い	anc
admission	入場|入学|許可|告白	anc
fantasy	空想|ファンタジー|想像|気まぐれ|空想文学作品|空想の産物|荒唐無稽|幻	anc
accommodate	便宜を計る|親切にする|に金を融通する|供給する|適応させる|和解させる	anc
capitalism	資本主義	anc
blast	爆発(させる)|スリル|楽しい時間|突風|非難(する)|台なしにする|枯らす|explosion	anc
developmental	開発の|開発的な|発生の|発達上の|発展的な	anc
forest	森林	anc
gang	囚人などの群れ|悪漢などの一団|遊び友達	anc
variance	変化|変動|くい違い|衝突|不和	anc
prisoner	囚人|刑事被告人|捕虜	anc
lease	賃貸契約|(土地･建物など)を賃貸する|賃借する	anc
vain	むなしい|むだな|空虚な|根拠の無い|つまらない|自惚れの強い|自慢にしている	anc
degradation	左遷|降職|デグラデーション|規模縮小|減成|分解|劣化|悪化	anc
inspiration	うまい思い付き|霊感|吸気	anc
ugly	醜い|(道徳的に)悪い|(天候)荒模様の	anc
silently	黙って|静かに	anc
abandon	を捨てる|放棄する|give up|desert	anc
exam	試験|examination	anc
inspection	検査	anc
inventory	物品明細表|在庫|在庫リスト	anc
endless	絶え間のない	anc
rail	レール|横木|手すり|欄干|罵る|非難する|クイナ(鳥)	original
patience	がまん|忍耐|一人トランプ	anc
legislative	立法権のある|立法の|立法機関(の)	anc
reinforce	部隊を強化する|を補強する|を強める|強化する	anc
lightning	稲光|稲妻|稲妻のような|すばやい	anc
gross	グロース(12ダース･144個)|グロス|粗悪な|総計の|ひどい|でぶの|粗野な|総計	anc
rebel	謀反|反逆者|謀反を起こす|調和しない	original
bolt	稲妻|かんぬきで締まる|ふるいわける|ボルトで締める|かんぬきをかける|(B-)人名	anc
inter	(死体を)埋める|埋葬する|葬る(bury)	anc
teaspoon	茶さじ	anc
alien	在留外国人|異邦人|異星人	anc
concert	コンサート|音楽会|演奏会|調和|一致|呼応|囃子|合奏|合唱|合意で解決する	anc
immigration	(外国からの)移住|入国(者)	anc
circular	円形の|円の|丸い|巡回の|ちらし|回状|循環する	anc
incidence	発生|落下|発生率･程度|範囲	anc
strictly	厳密に(言えば)|厳しく|きっちりと	anc
loudly	派手に|大声で	anc
singular	唯一の|並外れた|奇妙な|単数の|単数	anc
sovereign	主権者|君主|最高の	anc
reside	が備わっている|住む|居住する|駐在する|存在する	anc
surge	波立つ|波のように打ち寄せる|沸き上がる|揺らぐ|急増する|うねり|高潮|動揺|大波|殺到|高まり	anc
hallway	廊下|玄関	anc
virtually	事実上|実質的には	anc
influential	影響力のある|有力な	anc
lonely	連れのいない|孤独の|寂しい|心細い|孤立した	anc
aggressive	積極的な|攻撃的な|迫力たっぷりの	anc
trajectory	軌道	anc
considerably	かなり	anc
forecast	予報|天気を予報する|を予想する|前兆を示す|を予定する|予測	anc
nucleus	細胞核|核|心|中軸	anc
killer	殺し屋|殺す動物(器械)|殺人鬼	anc
spit	吐いた|つばを吐く|を吐く|つば(を吐く)	anc
frustration	欲求不満	anc
anterior	(時間が)前の|先の|(場所･位置が)前方の|前部の	anc
horn	角製のもの|角|角で突く|触覚|警笛|ホーン	anc
ban	禁止する|禁止|prohibit	anc
dwell	移住する|住む	anc
void	からの|を放出する|排泄する|放尿する|うつろな|持ち主の無い|空間|真空	anc
collar	首飾り(colorとは発音異なる)|えり|首飾|首章	anc
adjacent	隣接した|付近の|近接した|直前の	anc
portfolio	大臣の職･地位|(所有する)有価証券(一覧表)|紙ばさみ	anc
spray	スプレーする|吹き掛ける|葉や花が付いた小枝	original
gratitude	感謝の気持ち|感謝|報恩の念	anc
tragedy	悲劇|惨事|悲劇的物語|悲惨な出来事	anc
accumulation	集積|蓄積	anc
capitalist	資本主義者	anc
relevance	(当面の問題との)関連(性)|適切さ|妥当性	anc
fry	油で揚げる|電気椅子で処刑する|稚魚|(集合的)小さいもの(子ども･小動物)	anc
diffusion	普及|散布|拡散	anc
inhibit	することを禁ずる|を抑制する|妨げる	anc
steep	急勾配の|急な坂|急な･険しい|不法に高い	anc
rejection	拒絶|拒否	anc
workplace	職場	anc
inspire	に霊感を与える|気持ちを強く動かす|奮起させる	anc
wholly	全体的に|完全に|全く	anc
medieval	中世の|古めかしい	anc
legacy	遺産|遺物|先祖伝来のもの|形見	anc
damp	じめじめした|湿らす|湿気を帯た|湿った|湿り気|落胆|悪気|汚気|湿気	anc
hazard	危険にさらす|危険|冒険|偶然|運|災害|障害|要因となるもの	anc
beard	(通常複数形)あごひげ|ふさ毛	original
breeze	そよそよ吹く|微風|そよ風|動揺	anc
glucose	ぶどう糖	anc
triumph	大勝利|勝利|大成功|功績|大業績|勝ち誇り|勝利をおさめる|成功する	anc
interference	さしさわり|衝突|妨害|障害|干渉|邪魔|混信	anc
swim	泳ぐ	anc
creativity	創造性|独創力	anc
gravity	重大さ|厳粛さ|危険|重力|重量|比重 (Universal Gravity万有引力)	anc
diamond	ダイヤモンド(4月の誕生石)|ひし形|(トランプ)ダイヤ(の札)|(野球)内野|球場	anc
desirable	魅力がある|価値のある|望ましい|好ましい	anc
founder	倒れさせる|浸水する|失敗する	anc
blush	赤面|恥じらい|紅潮させる|恥じる|顔を赤らめる|赤面する	anc
onset	襲撃|攻撃|始まり|着手|手始め	anc
innovative	革新的な	anc
circulation	発行部数|循環	anc
railway	鉄道|軽便(路面)軌道	anc
correspondence	文通|通信|交通	anc
jail	刑務所|投獄する	original
broadcast	放送する|広く|放送	anc
olive	(色)オリーブ|薄緑色|オリーブ色|薄緑	anc
sauce	面白味|興趣を添えるもの|生意気(な言葉)|ソース|果物のシチュー煮|果物の砂糖煮|味を添えるもの	anc
prompt	を促す|駆り立てる|すばやい|即座の	anc
flexibility	柔軟性|屈折率	anc
dread	恐怖|を心配する|恐い|を(非常に)恐れる	anc
squeeze	締めつける|を絞る|圧迫する|強制する|規制|圧搾	anc
subordinate	を従属させる|副次的な|下位の|従属の	anc
evidently	明らかに	anc
mud	泥|つまらぬもの	anc
modify	修正する|緩和する|修飾する	anc
gonna	(俗)するつもりの(going to)	anc
reliability	信頼|頼もしさ|信頼性|信憑性|確度|確実	anc
electrode	電極	anc
disposition	性質|配置|廃棄	anc
dim	はっきりしない|うす暗い|かすかな	anc
goodness	よいところ|よい状態|神	anc
oven	オーブン	anc
recognised	認識	anc
cardiac	心臓(性)の|心臓病の(患者)|強心薬|心臓病の患者	anc
tide	潮|潮流|潮の干満|潮に乗って|潮汐	anc
cabinet	キャビネット|飾り戸棚|箱|私室|閣議室|秘密の|(C-)内閣	anc
festival	祭	anc
deliberately	ゆっくりと|慎重に|故意に	anc
harmony	ハーモニー|調和|一致|平和|和声	anc
lodge	泊まる|を預ける|提起する|を提供する|ゆだねる|観光地の旅館|山小屋|(弾が)入って止まる|(矢が)付き刺さる	anc
pillow	枕|まくら(をする)	anc
ha	おや|さあ|ほらね|まあ|エヘン|ハハ|haという声	anc
continent	自制心のある|大陸	anc
satellite	衛星|人工衛星|衛星国|衛星の|衛星中継する	anc
altar	祭壇	anc
theological	神学の	anc
illusion	思い込み|幻覚|幻影|思い違い|錯覚|妄想|幻想	anc
obscure	人目に付かない|ぼんやりした|あいまいな|覆い隠す	anc
theater	映画館|演劇|現場|観客|(重要な事件などの)舞台|戦域(個々の戦場を含む広い地域)	anc
backward	遅れている|後方へ|逆に|後ろに|以前に|嫌がる|発展の遅れた	anc
disclose	暴露する	anc
expectation	予期|期待	anc
kidney	腎臓|性格|気質|種類|型|キドニービーンズ(豆の名)	anc
widow	未亡人|余分の手札|未亡人になる	anc
mandate	の統治を委任する|命令|為政権|指図|委任統治	anc
bishop	ビショップ|司教|僧正	anc
disclosure	暴露|発覚|発表|打ち明け話|明細|公開	anc
inflammatory	扇動的な|怒りをかきたてる|感情を刺激する|激昂させる|煽動的な	anc
borrow	を借りる	anc
respiratory	呼吸の	anc
publicly	公に|公然と	anc
bundle	大金|包み|束|固まり|大量|小包	anc
hollow	くぼんだ|中がからの|空の|うつろな|くぼみ|穴|中空の	anc
citizenship	市民権	anc
fee	手数料|料金	anc
wheat	小麦	anc
intervene	干渉する|仲裁する|邪魔する|間に起こる|挟まる	anc
invention	発明品|発明|創案|考案	anc
exclusion	排他	anc
distinctive	独特の	anc
decay	衰えさせる|衰える|腐る|腐敗|虫歯になる|衰退する	anc
dish	大皿|盛り皿|盛付け料理|(口語)かわいこちゃん	anc
monk	修道僧|修道士|修道師	anc
shrink	しりごみする|縮まる|減る|恐れる|避ける|(俗)精神科医	anc
caution	注意	anc
mill	ひき臼|製粉機|水車場|工場|圧搾機|製粉する	anc
morality	道徳|道徳性|徳行	anc
lion	ライオン|名物男|人気者|勇敢な人	anc
dual	(文法)双数の|二者の|二重の|二つの部分から成る	anc
horrible	ひどくいやな|恐ろしい|身の毛もよだつ	anc
detective	探偵の|探偵|刑事	anc
declaration	宣言|通知|申告	anc
knight	騎士	anc
exile	追放(する)|亡命(させる)|亡命者|追放人|国外追放	anc
worldwide	世界的な(規模の)|世界中に広まった|世界中あまねく	anc
entertainment	もてなし|歓待|娯楽|催し	anc
recipient	受取人|受容者|受賞者|受け取る|感受性のある	anc
sovereignty	主権|統治権|支配権|独立|君主であること|独立国	anc
wive	〜‘を'めとる|妻帯する	ejdict
duck	アヒル(おしゃべり･あざむきの象徴)|かわいい人|ひょいと頭を引っ込める|かわす	anc
sensory	感覚(上)の|知覚の	anc
normative	規範的な	anc
comparable	比較できる|同等の	anc
hunger	空腹|飢え|飢饉|渇望	anc
attribute	のおかげとする|せいにする|に帰する|属性|特質	anc
frown	顔をしかめる|難色を示す|眉をひそめる|しかめ面|不満|怒りを表す	anc
charity	慈善|思いやり	anc
importantly	もったいぶって|重要で	anc
socially	社会的に|社交的に	anc
realization	実現	anc
reconstruction	復元|再建|改造|復興	anc
barrel	容器|樽(1barrel=約117.3リットル)|銃身|胴体	original
towel	タオル|手拭い	anc
acquaintance	面識|知識|知人|知合い	anc
shear	を刈る|はさみを入れる|奪い取る|剥奪する|大ばさみ|(羊毛の)刈り込み	original
lad	少年|若者|やつ|男	anc
shallow	浅い|浅はかな	anc
rotation	規則正しい交替|回転	original
neglect	を無視する|怠る|怠慢|無視	anc
explosion	爆発|破裂|急増	anc
wherever	どこでも|一体どこに|所ならどこへでも|どこへ～しようとも|いったいどこへ	anc
completion	完了|完全さ	anc
cease	しなくなる|をやめる|終わる	anc
volunteer	ボランティア|ボランティアの|有志の	anc
terrorist	テロリスト(の)	anc
researcher	研究者	anc
consistently	首尾一貫して	anc
problematic	問題のあった|問題の	anc
numerical	数の|実数の	anc
upward	上向きの|上へ|上方へ|上へ向かって|上流へ|内陸へ	anc
bit	わずか|かんだ|ビット|小片|小銭|少量|少し|(俗)12セント半	anc
flourish	栄える|華麗な身振り|見せびらかし	anc
pad	当て|詰め物|当て物|に詰め物をする|を長引かせる	anc
disappointment	落胆	anc
tag	に下げ札をつける|決まり文句|荷札|金具|尾|巻き毛|ナンバープレート	anc
contradiction	矛盾|否定|反対	anc
robust	丈夫な|健全な|頑丈な|体力のいる|粗野な|強い	anc
absorb	を吸収する	anc
knot	結び目|節|結ぶ	anc
certainty	確実性	anc
certificate	証明書|付保証明書|免許証|証券|株券|卒業証書|を認証する|与える	anc
allocation	割り当て	anc
amendment	修正(条項)|改正	anc
mount	取り付ける|昇|乗る|取りつける|上演する|標本にする|山	anc
mock	偽の|からかい|嘲り|嘲る|真似てからかう|馬鹿にする|無視する|まねる	anc
wipe	拭く|をふく|ぬぐう|ふき取る|一掃する|ふくこと	anc
gospel	ゴスペル(宗教音楽)|福音|福音書|信条	anc
holder	入れもの|所有者|入れ物|所有|支える	anc
crush	押しつぶすこと|粉砕	anc
coordination	(文法)同格関係	anc
renal	腎臓|腎臓(部)の	anc
sway	揺り動かす|を揺すぶる|を動かす|揺れる|動揺|支配する	anc
stamp	スタンプ|商標|切手|を踏みつける|をスタンプで押す	anc
mainstream	主流(の)	anc
corpse	(特に人の)死体|死骸	anc
disturbance	混乱|妨害	anc
assertion	主張	anc
bind	結ぶ|を束縛する|縛る|包む|を固める	anc
capability	将来性|能力|可能性|手腕	anc
intensive	強い|強調の|集約的な|(文法)強意の|強意語	anc
clay	粘土	anc
drum	太鼓|ドラム	anc
meta	(ギリシア語)meta- 超等の意味の接頭語	original
clerk	事務員	anc
unhappy	浮かぬ|不幸な|不運な|惨めな|適切でない	anc
accent	アクセント|口調|なまり	anc
hatred	憎しみ|憎悪	anc
intake	摂取量|水などの取入れ口|取り入れ	anc
sharply	鋭く|急に|はっきりと|厳しく	anc
continuously	連続して|引き続き	anc
commerce	商業|貿易|交易|交際|商学|コマース	anc
jar	かめ|びん|きしむ|がたがた揺れる	anc
appreciation	感謝|高い評価|正しい認識|鑑賞	anc
meditation	めい想|瞑想|熟慮	anc
awkward	不器用な|ぎごちない|見苦しい|へたな|まずい|厄介な	anc
impressive	強い印象を与える|印象的な|感動的な	anc
compassion	思いやり|哀れみ|同情	anc
esteem	尊重(する)|重んじる|尊ぶ	anc
witch	魔女|醜い女|に魔法をかける	anc
exert	及ぼす|発揮する|力を出す|感化を及ぼす|働かせる	anc
cliff	がけ|崖	anc
ignorance	無知|無学|不案内	anc
utterly	全く|完全に|徹底的に	anc
convenient	便利な	anc
historic	歴史上重要な|歴史上の|歴史的に有名な|歴史に残る	anc
binary	二進法の	anc
cottage	別荘|小屋	anc
rod	魔法の杖|棒(権力･支配力の象徴)|(俗)ピストル|釣り竿|ものさし|ロッド(単位)|桿状菌	original
cart	荷車	anc
correction	修正相場|訂正	anc
consequently	その結果として|結果として|必然的に|したがって	anc
positively	確実に|明確に|確信して|肯定的に|積極的に	anc
missionary	伝道(者)の|伝道師|宣伝者|使節	anc
vitamin	ビタミン	anc
spouse	配偶者	anc
den	動物の住む穴|動物園の檻|住みか|書斎	anc
clever	利口な|賢い|上手な|得意な	anc
feast	祝宴|宴会|ご馳走|祭日|を大いに楽しむ|もてなす|ごちそうになる|ごちそうする	anc
occasional	時々の|予備の|ときおり|時折の|特別な場合のための|臨時用の	anc
pill	丸薬|経口避妊薬|不愉快な人|弾丸|苦しいこと	anc
discount	ディスカウント|割引	anc
canal	運河	anc
catalyst	触媒|触媒のはたらきをする人	anc
vague	ばく然とした|曖昧な|ぼんやりした|あいまいな	anc
chaos	混乱状態	anc
rigid	厳格な|かたくなな	anc
execute	芸術品を創作する|果たす|実行する|演奏する|契約を履行する|死刑にする	anc
behold	見る|眺める|注意して見る	anc
accurately	きちんと|正確には	anc
revenge	の復讐をする|復讐する|報復|仕返し|遺恨|復讐心	anc
complement	補足|全数量|補足物|(文法)補語|補文|補数	anc
basically	基本的に|根本的に	anc
reproduction	複製品|複製|模写|再版|生殖|再現|再生|再演	anc
pine	松(の木)|思い焦がれる|やつれる	anc
accordingly	それゆえ|というわけで	anc
preliminary	予備の|準備的な|仮の|前置きの|発端の|序の|下ごしらえ|予備試験	anc
con	反対の	anc
mentor	よき助言者|相談相手|よき指導者	anc
bike	自転車|オートバイ|オートバイで行く	anc
luxury	豪奢な(品)|ぜいたく|快楽|贅沢(品)|おごり|満足|贅沢な	anc
prop	支持者|支え|を支える|を支持する|に支柱を施す	anc
automatic	自動的|自動の	anc
surgeon	外科医|(海軍の)軍医|船医	anc
continually	ひんぱんに	anc
characterize	の特性を示す	anc
reasonably	合理的に	anc
specification	明細書|仕様|詳説|詳述|明細事項|仕様書	anc
envelope	包装材料|封筒|包むもの	anc
hop	跳躍|ぴょんと跳び越す|(植物)ホップ|ホップの実(ビールの苦味をつける)|麻薬|阿片	anc
legend	言い伝え|伝説|題銘|表題|解説	anc
fiscal	国庫収入の|財政上の|会計の|国庫の|収入印紙|財務の	anc
soup	スープ	anc
shaft	シャフト|矢がら|ハンマーなどの取っ手|光の一筋	anc
onion	玉葱|タマネギ	anc
miserable	悲惨な|みじめな|不幸な|粗末な|不愉快な|恥ずべき|けちな	anc
princess	プリンセス	anc
ankle	くるぶし|かかと|足関節	anc
persistent	固執する|しつこい|持続する|永続的な|不屈の|頑固な|永続性の|不変の	anc
porch	ベランダ|玄関|車寄せ	anc
surveillance	(容疑者や敵の)監視|見張り|見渡す|調査する|監督	anc
immense	莫大な|巨大な|限りない|すばらしい	anc
happily	しあわせに|幸福に|楽しく	anc
placement	置くこと|配置|職業紹介	anc
gradient	こう配|変化度|勾配	anc
bacterial	バクテリアの	anc
thunder	雷|雷鳴|落雷|雷が鳴る|を大声で言う	anc
weigh	(重さを)量る|重荷になる|出航する|よく考える|重要である	anc
mouse	ハツカネズミ(ratはドブネズミで大きい)|臆病物|かわいい子	original
controversy	論争|討論	anc
hunter	狩猟訓練をした動物|狩りをする人|探求者	anc
impairment	(価値･美点･健康を)減じる|害する|そこなう|傷つける	anc
delicious	おいしい	anc
monetary	貨幣の|金銭上の|金融の	anc
foolish	ばかな	anc
biblical	聖書の|聖書にある|聖書のような	anc
bother	を悩ませる|困らせる|を気にする|面倒|やっかいなもの	anc
offence	攻撃|違反|罪|侮辱|立腹	anc
midnight	真夜中|真夜中の	anc
handful	ひと握りの量|小数|一握り|少量	anc
mortal	死を免れぬ運命の|死すべき|人間の|死ぬべき運命の|死ぬ運命にある|命にかかわる|ひどく	anc
exhibition	見せること|展覧会|公示|発揮|展示|展覧|出品物	anc
tomb	墓|墓穴|墓石|墓標|死	anc
compete	競争する|匹敵する	anc
broadly	露骨に	anc
dominate	支配する|著しく目立つ	anc
expedition	探検|旅行|長い旅|長征|遠征	anc
prey	犠牲(にする)|餌食(にする)|えさ|捕獲|捕食(する)	anc
lab	研究所|laboratory	anc
celebration	祝賀|式典	anc
locate	位置する|ある|場所を見つける	anc
confront	に立ち向かう|直面させる|直面する|立ち向かう	anc
super	すばらしい|管理人|端役|とても	anc
stance	姿勢	anc
cellular	細胞の	anc
romance	伝奇物語|空想小説|ロマンス|作り話|虚構|ロマンチックに考える|言い寄る|の歓心を買う	anc
voluntary	自発的な|自由意志による|有志の|無償の	anc
momentum	はずみ|いきおい|(物理)運動量|契機|弾み|惰性	anc
skull	頭蓋骨|頭	anc
silly	ぼうっとした|愚かな(stupid)|ばかげた(foolish)	anc
wagon	乳母車|荷馬車|ワゴン	anc
independently	自主的に|自由に|他と関係なく|独自に	anc
remark	と述べる|言う|意見|言葉	anc
overhead	オーバーヘッド|頭上の|頭上で|頭上にある	anc
veil	ベール|顔おおい|おおい隠すもの|を覆う	anc
differentiation	区別	anc
primitive	原始的な|原始人|原始の|昔の|太古の|最初の|初期の	anc
fatal	致命的な	anc
marble	おはじき|大理石|大理石の彫刻|知恵	anc
assign	を割り当てる|指定する|任命する|当てがう	anc
definite	明確な|限定された	anc
fur	毛皮(製品)|柔毛|毛皮製品	anc
testify	証明する|を証言する	anc
moan	うめき声|不平|うめき声を出す	anc
participant	参加者|関係者|関与する	anc
alternate	かわるがわる|互い違いの	anc
covenant	契約する|(二国間または多国間の)契約|盟約|誓約|約款	anc
manipulate	操作する|ごまかす	anc
flavor	風味|趣き|味	anc
cage	骨組み|鳥篭|監獄|ゴール|かご(にいれる)|(ボール･パックを)ゴールにいれる	anc
fame	名声	anc
toxic	有毒な|中毒の	anc
retail	小売り商の|小売り|小売りで|を言いふらす|小売店	anc
likewise	その上に|さらに|同様に	anc
pulmonary	肺の|肺疾患の	anc
admire	に感服する|を賞賛する|尊敬する	anc
clinic	臨床講義|診療室|クリニック	anc
peripheral	周辺の|末梢性の	anc
residual	残余の|剰余の|残りの	anc
reckon	計算する|数える|勘定に入れる|判断する|みなす|思う	anc
retirement	退役|退職|隠退|引退|退去|勇退	anc
humor	ユーモア|こっけい|機嫌|気性|の機嫌を取る|うまく合わせる	anc
carpet	じゅうたんを敷く|じゅうたん	anc
recruit	新社員|補充兵|新参者|を募集する|を強化する|補充する|人員を募る	anc
abundance	豊富さ|affluent|豊富な|多数|多量|発生量	anc
fraud	詐欺(行為)|欺瞞|ごまかし|詐欺師	anc
contend	強く主張する|競争する|論争する|戦う	anc
cultivate	交際を求める|耕作する|耕す|養殖する	anc
tomato	トマト|女|娘	anc
severity	厳格|重大度	anc
continuity	連続性	anc
tray	盆|受け皿|料理をもった皿	anc
highway	主要ルート|ハイウェイ|幹線道路	anc
lobby	ロビーに出入りする|議員に働きかける|の通過運動をする|圧力団体|ロビー|大廊下	anc
hostile	敵意のある|敵の|敵国の|敵対する	anc
elevator	エレベーター	anc
architect	建築士|建築家|設計者|建設者	anc
fond	愛情のこもった|好きな|好んで|優しい|盲愛の	anc
cooperative	協同組合の|協力の|共同～	anc
sunlight	日光	anc
micro	極端に小さい|顕微鏡でしか見えない|超ミニの|極小の|超ミニスカート	anc
inference	推論	anc
causal	原因の|因果の	anc
secular	俗人の|世俗の|非宗教的な|修道院外の|修道院外の僧侶	anc
fragment	破片|断片|かけら|小部分|断章	anc
characterization	特性づけ|性格描写	anc
commentary	注釈書|注釈|注解書	anc
stiff	肩こり|こわばった|堅苦しい(人)|不自然な|(俗)勃起|死体|浮浪者	anc
gown	ガウン|長上着|正服|法服	anc
chemistry	化学|相性	anc
glare	ぎらぎらする光|目だつこと|ぎらぎら光る|睨み付ける	anc
offense	違反|罪･攻撃|侮辱|立腹|不快なもの	anc
norm	基準労働量|標準	anc
precision	精密な|正確|精密|細心|几帳面さ	anc
gallery	天井桟敷|画廊|美術館|柱廊|観衆|傍聴人	anc
supervision	管理|監督|指揮|監視	anc
wit	知力|分別|ウィット|機智 (複数形witsも使用)|(W-)人名	anc
dataset	データセット	anc
favourite	favoriteの英国綴り	anc
habitat	生息地|環境|居住環境|生育地|すみか|居住地	anc
queer	体の調子が悪い|ぶちこわす|妙な|奇妙な|変な|気分が悪い|不正の|いかがわしい	anc
initiate	始める|起こす|創始する	anc
ward	かわす|撃退する|(選挙などの)区|被保護者|保護|監房|病棟|中庭|(カギの)刻み目|突起	anc
criterion	(pl|criteria)|規準|基準|(判断･批評の)標準|特徴	anc
stain	しみ|汚れ|汚点	original
surrounding	周囲の|付近の	anc
escort	護衛する|護衛|付き添う	anc
resistant	抵抗力のある	anc
petition	嘆願|請願(書)|申し立て(書)|を請求する|を願う	anc
assurance	保険|確かさ|確実さ|保証|請合い|言質|安定|安泰	anc
countless	無数の	anc
mistress	女主人|主婦|女教師|女性の大家|情婦	anc
correspond	一致する|対応する	anc
incredible	信用出来ない|うそのような|途方もない|驚くべき|信じられない	anc
girlfriend	ガールフレンド	anc
calcium	カルシウム(金属元素)	anc
supper	夕食(会)|夜食	original
suppress	を抑圧する|鎮定する|抑える|を鎮圧する|を我慢する|を隠す	anc
accommodation	適応|和解|便宜|順応|宿泊施設|好意	anc
clan	一族|一味|仲間	anc
serum	血清	anc
ours	わたしたちのもの	anc
substantially	しっかりと|実質的に|十分に	anc
collaborative	共同の|共同作業の|合作の	anc
tablet	平板|書き板|錠剤	anc
melt	溶ける|和らぐ|融ける|次第になくなる|次第にやわらぐ|融かす	anc
rhetoric	レトリック|修辞|口先だけの発言	anc
tolerate	許容する|容認する|大目に見る|我慢する|寛大な|耐性のある|寛大に取り扱う	anc
socialist	社会主義者|社会主義(者)の	anc
inflation	インフレーション|インフレ|暴騰|膨張	anc
tobacco	たばこ|刻みたばこ|喫煙	anc
coastal	海岸の	anc
texture	織り目|構成|生地	anc
stranger	よその人|他人|見知らぬ人|奇妙な	anc
radius	飛行半径|半径|輻射線|区域|範囲	anc
magical	魔法の|魔法の力による|不思議な|魅惑的な	anc
bride	花嫁|新婦	anc
separately	離れて|別々に	anc
solvent	溶媒|溶解力のある|解決方法|支払能力がある	anc
evolutionary	進化した	anc
underground	反体制の|地下の|秘密の|(UK英)地下鉄|(米)地下道	anc
shine	光らせる|輝く|を磨く|光|cancel|blow off	anc
bend	に取り組む|屈伏する|たわむ|曲げる|向ける|曲がり|屈曲|カーブ	anc
contractor	建築請負人	anc
nitrogen	窒素|元素記号N	anc
aura	雰囲気|前兆|気配|発散物|オーラ|崇高さ	anc
injustice	不正	anc
skip	(授業を)さぼる|スキップする|はね回る|軽く跳ぶ|縄跳びをする|を軽く跳び越す	anc
notable	注目に値する|著しい|著名な|名士|著名な事物	anc
probable	ありそうな|ありうる|もっともらしい|有望な	anc
headache	頭痛がする|頭痛|悩みの種	anc
partition	区画|分割|分配|区分|分離|を分割する	anc
apologize	謝罪する|謝る|わびる|あやまる	anc
restoration	復旧|返却|復興|回復|返還	anc
openly	公然と|率直に	anc
sandwich	サンドイッチ	anc
formerly	以前は	anc
snap	急な|即座の|パチン(と音をさせる)|ぽきんと折(れ)る|パクッ(とかみつく)|鋭い口調で言う|写真を撮る	anc
registration	書き留め|記載|記名|登録	anc
regain	取りもどす|回復(奪還)する	anc
geometry	幾何学	anc
weary	疲れた|退屈な|飽き飽きして|うんざりした	anc
ridiculous	けしからぬ|おかしい|ばかげた	anc
glorious	すばらしく愉快な|名誉ある|光栄ある|荘厳な|光輝く	anc
th	序数(順番)を表す	anc
decent	礼儀正しい|上品な|親切な|(口)結構な|まあまあの|悪くない	anc
installation	装置|設備|軍事施設|基地	anc
provider	供給者|(一家の)主人	anc
abide	がまんする|とどまる|待つ|従う|住む|規則を守る	anc
scholar	学者|奨学生	anc
downstairs	階下に	anc
inflammation	燃焼|炎症	anc
vow	を誓う|と断言する|誓約|pledge	anc
inheritance	相続財産|遺産|継承物|遺物|相続|遺伝	anc
vibration	心の動揺|振動する(させる)こと|動揺|(米俗)感じ	anc
advise	に忠告する|に助言する|通知する	anc
saving	節約する|救いの|節約|倹約(の)	anc
suspicious	疑い深い|疑わしい	anc
underneath	〜の下に	original
aloud	声を出して|大声で	anc
heap	積み上げる|山|沢山の|たいそう|非常に	anc
accord	調和(する)|協定|合意(する)|一致|与える|agreement	anc
resonance	共鳴|共振	anc
sodium	ナトリウム(英sodium|独Natrium)	original
selective	選択の|注意深く選ぶ	anc
prevalence	普及|流行|(医)有病性|率	anc
noun	名詞	anc
semantic	意味の	anc
legitimacy	合法性|正系|正統|妥当性|嫡出|適法|道理にかなっていること	anc
bat	コウモリ|強打	anc
ashamed	恥ずかしがって|恥ずかしく思う|恥て	anc
consultation	相談|会議|協議	anc
seldom	めったに～しない|めったに～ない	anc
misery	不幸|みじめな|みじめさ|窮乏|苦難|苦痛	anc
progression	進行|前進|行程|経過|発達|数列|発展|連続|連鎖	anc
savage	野蛮人|無礼な|下品な(ラテン語silvaticus｢森の｣から)|獰猛な|未開の	anc
whereby	なにによって|そのために|何について|どのようにして|どういう手段で|それによって	anc
unnecessary	不必要な|余計な|無益な|無用な	anc
lid	ヘルメット|マリファナの小さな包み|蓋|ふた|目蓋	anc
seller	売れるもの|売り手|よく売れるもの	anc
barn	納屋|物置|倉庫	anc
stall	畜舎に入れておく|(口実をもうけて)言い逃れする|エンストする|立ち往生する|馬房|露店	anc
presidential	大統領の	anc
herd	(牛馬の)群れ|群衆|多数の|群がる|集まる	anc
implant	(心など)に植え付ける|深く刻みこむ|教えこむ|移植する|移植組織	anc
geographical	地質学上の	anc
politically	政治的に	anc
fairy	妖精|(俗)ホモ	anc
intrinsic	本質的な|本来備わっている|固有の	anc
coalition	(一時的な)連合|連立|一体化	anc
marginal	取るに足りない|最低限の|周縁の|辺境の|欄外の|限界収益点の	anc
urgent	緊急の|緊迫した|催促する|執拗な	anc
saddle	課す|サドル|負わせる|鞍|に鞍をつける	anc
boom	にわか景気|オイルフェンス|とどろく音|ドカーン|ブンブン	anc
metabolic	新陳代謝の|変態の	anc
decree	法令|布告|制令|判決|命令|命ずる|決定する	anc
metabolism	代謝|新陳代謝|物質交代	anc
succession	連続(物)|継承|相続	anc
bodily	身体の|肉体の	anc
spear	やり|槍|やりで突く	anc
vocabulary	語彙|用語範囲|単語集	anc
notably	明白に|著しく	anc
boyfriend	ボーイフレンド	anc
colony	植民地|移民	anc
announce	を発表する|を知らせる	anc
lane	狭い道|小道|通路|小径	anc
bump	どすんと当てる|衝突|ドスン|衝突の音	anc
dye	染まる	anc
outward	外へ向かう|表面上の|肉体の|外へ|外見|外部へ	anc
unemployment	失業	anc
physiological	生理学上の|生理的な|生理学の	anc
perfection	完全(なこと)|完成|完成の域に達した人(物)	anc
mankind	人類	anc
flap	ぴしっとたたく|ひらひらする|はためく|羽ばたく|はためかせる|平手うち|興奮状態|騒動	anc
bang	バンと音を立てる|バタン|バーン|ドカン|ドアなどを閉める音	anc
courtyard	中庭	anc
exploitation	活用|開発|宣伝|搾取	anc
comprehend	を理解する|把握する|を包含する|含む	anc
basin	洗面台|たらい|洗面器	anc
consistency	一貫性|一致|濃度|堅さ|粘り	anc
disguise	本性を偽る|変装する|隠す|変装|(人目をごまかす)偽り|ごまかし	anc
arbitrary	独断的な|任意の|気まぐれの|恣意的な|不定の	anc
plague	伝染病|天災|災難|疫病神|を苦しめる|悩ます	anc
creep	忍び寄る|はう|いやな奴|薄気味悪い感じ(を与える人)	anc
authentic	信頼できる|信憑性のある|本物の	anc
resident	居住する|居住者	anc
ridge	山の背|に棟をつける|棟|尾根|背筋|うね|畝	anc
orbit	軌道|行路|眼窩|眼球孔|の周りを回る|軌道を周回する	anc
implicit	暗黙の|暗示的な|絶対の|絶対的な|(反義語)explicit	original
realistic	現実主義の	anc
secretly	秘密に	anc
drawer	引き出し	anc
machinery	(集合的に用いて)機械類|機械装置|機構	anc
toilet	化粧|便所|便器|洗浄|トイレ	anc
pinch	つまむ(こと)|はさむ(こと)|苦しい状況|危機	anc
jet	噴出|噴出物|噴出する|ジェット機で輸送する	booqs
leak	を漏らす|情報漏れ|漏電	anc
gasp	あえぎながら言う|息を切らす|はっと息をのむ|求めてあえぐ|あえぎ|息を飲む	anc
noon	正午	anc
piano	ピアノ	anc
ladder	はしご|地位|(パンストの)伝線(run)	anc
morrow	朝|翌日|(事件の)直後	anc
fusion	核融合|融解|融合|溶融|合併|連合|統合	original
judgement	判断|判断力|分別|裁判|判決|意見	anc
packet	小包|束|包み|小荷物|小さな束|大金|通信の単位	anc
compensate	に補償する|補償する|補正する|補正を行なう	anc
upright	まっすぐ立った|直立の|まっすぐな|垂直な|直立した	anc
painting	塗る|絵(を描くこと)|画法|ペンキを塗ること|塗装|水彩画|油絵	anc
unfortunate	不運な|不幸な|運の悪い|残念な|不運な人	anc
pioneer	開発者|開拓者|先駆者|パイオニア|を開拓する|先駆者となる	anc
preservation	維持|保存	anc
molecule	分子|微量|微分子	anc
tenant	借家人|借地人|居住者	anc
mortgage	抵当|抵当に入れる|賭ける	anc
blink	まばたきする|きらめき|まばたき	anc
supervisor	指揮者|監督者|管理者	anc
adaptive	適用可能な	anc
cement	セメント|つなぐもの|接着剤|絆|固める	anc
kindly	思いやりのある|親切に	anc
stimulation	刺激|興奮|激励|鼓舞	anc
lace	をひもで縛る|レースで飾る|レース|組み紐|ひも	anc
inevitably	不可避的に|必然的に|必ず|確かに	anc
par	同等|平価|標準|基準|パー|基準打数	anc
triangle	三角定規|三角形|三人組み	anc
deliberate	意図的な|故意の|慎重な|熟考する	anc
lipid	脂質	anc
quotation	見積書|引用|相場|引用すること|引用文|時価|見積り	anc
undoubtedly	疑いなく|疑う余地なく|確かに	anc
rubber	ゴムタイヤ|天性ゴム|弾性ゴム|紙やすり	anc
league	盟約を結ぶ(結ばせる)|同盟|連盟|仲間|同盟する(させる)	anc
cavity	虫歯|虫歯の穴|くぼみ|うろ	anc
withdrawal	取り消し|引っ込めること|回収|脱退|撤退|預金の引き出し|払い戻し	anc
amino	アミノ基の	original
corrupt	堕落させる|堕落した|買収された|崩れた|汚れる	anc
institute	設立する|始める|会|協会|実施する|起こす	anc
hesitate	躊躇する|ためらう	anc
straightforward	率直な|まっすぐな|まっすぐに	anc
monthly	毎月の|月1回の|月経の|毎月|月間刊行物|月経|月刊誌	anc
gland	腺|パッキン押さえ	anc
sneak	こそこそする(こと)|こっそり盗む･取る･入れる	anc
presently	まもなく|やがて|目下|只今	anc
imperative	命令的な|避けられない|緊急の|絶対に必要な|強制的な|(文法)命令法(の)	anc
pension	年金|に年金を与える	anc
facial	美顔術|顔の|顔に用いる|美顔用の	anc
sadness	悲しみ|悲しさ	anc
maximize	極大化する|最大にする	anc
severely	厳しく	anc
heir	相続人|継承者|後継者	anc
discrete	個々の|分離した|別々の|別個の|不連続の	anc
destiny	運命	anc
magnificent	壮大な|壮麗な|雄大な|崇高な|すばらしい|堂々とした|立派な|格調高い	anc
boost	を押しあげる|上げる|強化する|後援する|値上げ|後援|尻押し|景気づけ|increase	anc
indicator	メーター|指示薬|ウィンカー|方向指示灯	anc
instructor	インストラクター	anc
apparatus	装置|器具|機構|機関|組織	anc
rat	スト破り|裏切者|密告者|ノネズミ|ドブネズミ(mouseハツカネズミより大きい)	anc
puzzle	を当惑させる|困らせる|難問|パズル	anc
diary	日記	anc
oak	オーク材の|オーク|カシ|ナラ	anc
analogy	相似(生命化学)|外見や機能は似ているが遺伝子が共通の祖先に由来しないこと|(対義語)homology|類似|類推	original
ally	同盟(させる)|同盟国|同盟者|連合国	anc
racism	民族優越観|人種差別|人種差別主義	anc
confession	自白|告白|自供|懺悔|告白文学|白状|信仰告白	anc
endeavor	～しようと努力する|試みる	anc
consist	構成されている|存在する	anc
singer	歌手	anc
visitor	訪問者|見舞人|滞在客|観光客|(スポーツ)遠征軍	anc
frontier	フロンティア|国境|辺境地帯|未研究分野|境界	anc
inclusive	包括的な	anc
weekly	毎週の|毎週|週刊誌	anc
poetic	詩の|詩的な|詩のような|詩人の	anc
temptation	誘惑|誘惑物	anc
inadequate	不適当な|不十分な|無力な	anc
baseline	ベースライン(基線)	anc
disagree	意見を異にする|と一致しない|相違する|口論する	anc
warn	に警告する	anc
insulin	インスリン(糖尿病薬)	anc
disrupt	分裂させる|中断させる|崩壊させる	anc
presumably	おそらく|たぶん	anc
ego	自我	anc
tremendous	ものすごい|途方もない|途方もなく大きい|ばかでかい	anc
remainder	(算数)余り|残余|残留者|残り物|遺跡|継承権	original
neighbour	に隣接する	anc
inability	不可能	anc
steadily	しっかりと|着々と|こくこくと	anc
fetch	取ってくる|引出す|(物を)行って取ってくる|取って来ること	anc
pie	パイ(食べ物)|総額|楽なこと|カササギ	original
comic	喜劇の|こっけいな|マンガ(の)|漫画	anc
shelf	棚|たな|棚の上のもの|棚状のもの	anc
pistol	ピストル|ピストルで撃つ	anc
admiration	感嘆|賞賛	anc
reminder	思い出させる人･物|記念物|注意|助言|催促状	anc
quest	探求|探索|クエスト|を探索する	anc
historically	歴史的に	anc
restrict	を制限する|限定する	anc
seizure	つかむこと|没収|占領|発作|てんかん	anc
punish	罰する|人を罰する|人を懲らしめる|をひどい目に合わせる|処刑する|酷使する	anc
biology	生物学|生態学	anc
autonomous	自治の|自治権のある	anc
willingness	快く(喜んで)すること	anc
approximate	おおよその|接近する|隣接の|近似の|近付く|近似値	anc
roast	ロース肉|を焼く|あぶる|焼き肉|焼いた|あぶった	anc
monument	記念碑|遺跡|記念物|不朽の業績|墓石	anc
descent	下り坂|下降	anc
railroad	鉄道	anc
toss	を投げる|寝返りをうつ|を激しく動揺させる	anc
flux	絶え間ない変化|不安定|流れ|流量|溶剤	anc
threaten	をおどす|を脅迫する|をおびやかす	anc
governmental	政府の	anc
goat	ヤギ|好色漢	anc
sting	(を針で)刺す|傷つける|をひりひりさせる|(人を)苦しめる|ひりひり痛む|ひどく痛む|刺すこと|針	anc
sheer	全くの|険しい|直立の|切り立った	anc
cloak	覆い隠す|マント|覆い|口実|覆い隠すもの	anc
elegant	気品のある	anc
genome	ゲノム|生殖細胞に含まれる染色体または遺伝子全体|ある生物の持つ全ての核酸上の遺伝情報	anc
documentation	書類の作成	anc
autumn	秋(=fall)	anc
denial	否認|否定|拒否|拒絶	anc
elevation	上げること	anc
fog	を濃霧で包む|当惑|霧|濃霧|煙霧|煙|ほこり|混乱|を曇らせる|を混乱させる	anc
hardware	ハードウェア|金物類|金属製品|機械設備	anc
disposal	支配権|配置|配列|処理|売却	anc
accountability	説明義務|会計責任	anc
successor	後継者|後任者	anc
transparent	透明な|明白な|透き通る|透けてみえる|薄い|率直な|わかりやすい	anc
posture	状態|事態|状況|姿勢|体位|身構え|心構え|態度	anc
costume	の衣装を用意する|衣装	anc
controller	支配者|管理人|制御(操縦)装置	anc
prospective	見込みのあった|将来の|期待される	anc
flee	(人･場所)から逃げる|消える|を捨てる	original
vascular	脈管の|血管の|管の	anc
deposition	罷免|証言録取書|宣誓供述書|堆積作用|堆積物	anc
maturity	満期|成熟|十分な成長	anc
flock	集まる|群がる|群れ|大勢|羊毛･綿などのふさ･くず	anc
clip	切り取る|クリップ	anc
nightmare	うなされること|悪夢(のような経験)|恐怖|夢魔	anc
approximation	近付くこと|接近|近似|近似値	anc
champion	支持する(stand up for)|のために戦う	anc
deadly	命にかかわるような|致命的な|執念深い|死んだような	anc
demographic	人口統計学の	anc
analyst	分析家|解説者|解剖学者|分解者|精神分析(学)者|金融アナリスト|財務分析者	anc
loyal	忠誠な|忠義な|忠実な|忠臣	anc
mist	霧|ミスト|かすみ|霞|意味をぼんやりさせるもの|曇る	anc
deputy	代理人|副～|代理|副|代理の	anc
devotion	深い愛情|献身	anc
rabbit	ウサギ	original
earthquake	地震	anc
yeah	はい	anc
repetition	繰り返し|くり返し|反復|再上演|再現	anc
forgiveness	容赦|許し|免除|寛大さ	anc
martial	好戦的な|軍の|戦争の|軍人らしい	original
lemon	レモン|(俗)欠陥品|不良品|きずもの	anc
activate	放射能を与える|活性化する|活動的にする|活動させる	anc
abundant	豊富な	anc
qualify	に資格を与える･得る|適格とする|限定する|修飾する	anc
resilience	弾力|反発|回復力|快活	anc
cooling	冷却	anc
sensible	(人行動など)分別のある|目的にかなった|賢明だ|顕著な|思慮のある|賢明な	anc
supreme	最高の|主権を有する|究極の|絶頂|至高の|最後の	anc
poorly	貧しく|不十分に|不完全に|まずく	anc
maternal	母らしい|母の|母方の	anc
thrive	成長する|を生き甲斐にする|栄える|繁栄する|繁盛する|(人･動植物が)力強く成長する	anc
dot	点を打つ|小数点|点	anc
casual	さりげない|くだけた|偶然の|不用意の|のんきな|臨時の|略式の|即座の	anc
formally	正式に|本式に|公式に|儀式張って|堅苦しく|形式上|形式的に|外見的に|礼儀正しく	anc
earnings	所得|利益|稼ぎ|生活力|儲け	anc
competent	有能な|合法的な	anc
abnormal	異常な	anc
insufficient	不適当な	anc
sexuality	性的要素|性別|性欲|性機能	anc
appetite	食欲|性欲|欲求	anc
nail	(人間の)爪タバコ|殴る|逮捕する	anc
desperately	死にもの狂いに	anc
variability	変動性	anc
imaginary	想像上の|架空の|虚の|(an imaginary number虚数|imaginary|ある物事が想像としてのみ存在する|非現実的な|imaginative|想像力の豊かな)	anc
dock	ドックに入れる|ドッキングする|(植物)スカンポの類	anc
motive	動機|目的|主題|原動力となる	anc
helpless	無力な|無力の|自分ではどうすることもできない	anc
emission	排出|放出|排気|放射|発射	anc
groan	うめく|唸る|うなるような音を立てる(grownと同発音)|ブーブー言う|きしむ|不満の声(をあげる)|うめき声	anc
dilemma	ジレンマ|板ばさみ	anc
territorial	領土の	anc
toxicity	毒性	anc
receiver	受取人|収入役|会計係|接待者|受話器|受信機|容器	anc
globe	地球儀|球体|天球|球|地球	anc
summarize	を要約する	anc
ranch	大牧場|農場|農園	anc
residential	住居の	anc
sob	すすり泣き|ざわざわいう音|むせび泣きながら～を言う	anc
coldly	冷たく	anc
defensive	防御の	anc
clarity	明瞭|明快|清澄さ|透明さ	anc
validation	検証	anc
tooth	歯|(複数形はteeth)|(食物の)好み	anc
violate	に違反する|(法律･規則)を破る|を妨害する|犯す|違反する|乱す|強姦する|邪魔する	anc
voyage	航海|船旅|飛行|航海記|航海する|(海を)渡る	anc
regiment	連隊|組織化する|厳しく統制する	anc
generator	発電機	anc
preach	説教する|を伝道する|を説く	anc
arena	競技場|土俵|闘争の場|闘技場|試合場	anc
relational	リレーショナル|関係の	anc
favorable	好意ある|好意的な|賛成の|都合のよい|有利な|望ましい(=favourable)	anc
token	しるし|印|徴候|証拠|記念品|土産|表象|記念の品|(形容詞的に)形だけの	anc
rent	(家･車など)を賃借りする|を賃貸しする|使用料|賃貸料	anc
righteous	正義の|正しい|有徳の	anc
intersection	交差|交差点	anc
oath	神名濫用|のろい|悪罵|誓い|宣誓	anc
surprisingly	驚くほど(に)|意外にも|驚くほどに|あきれるほど|驚いたことには	anc
albeit	(ɔːlbíːɪt)にもかかわらず|=although	anc
synthetic	合成した(fiberなど)|総合的な	anc
grammar	文法学|文法	anc
oneself	自分自身|自ら	anc
depart	規則から逸脱する|立ち去る|出発する|軌道からそれる|この世を去る	anc
generic	ノーブランドの|属の|一般的な|包括的な|(文法)総称的な	anc
graft	(骨の折れる)仕事|挿し木|移植する	anc
compression	圧縮	anc
limitation	限度|限界	anc
furious	すさまじい|狂った|激怒した|激しい|荒れ狂う	anc
graphic	グラフィック|グラフの|図画の|グラフィックアートの|目のあたりに見るような|生きいきとした	anc
passionate	熱烈な|熱情的な|短気な|好色な	anc
pore	(本などを)じっくり見る|熟読する|熱中する|精査する|(on|upon|over)|毛穴|(岩石などの)細孔|(葉の)気孔|(人体内の)導管|毛穴	anc
bastard	雑種の|不純な|偽の|偽物|粗悪品|私生児|庶子|野郎	anc
raid	急襲(する)|引き抜き|襲撃(する)|侵略|奇襲|手入れ|かき乱す|attack	anc
navigate	を航行する|(船･飛行機)を操縦する	anc
hedge	保険つなぎ|ヘッジ取引|行動を妨げる|生け垣(を作る)|垣根|境界|防御物	anc
outstanding	際だった|目立つ|未解決の|未払いの	anc
closet	密談させる|戸棚|人に知られていない|隠れた	anc
shy	後ずさりする|しりごみする|恥ずかしがりの|内気な|恥ずかしがり屋の	anc
arc	弧(こ)	anc
anticipate	予期する|予想する	anc
dislike	きらう|嫌う	anc
thorough	完全な|徹底的な|心からの|絶対的な|詳細な	anc
flip	はじく|軽く打つ|弾く|ポンと打つ|宙返り|(アザラシ等の)ひれ足	anc
sympathetic	思いやりのある|同情的な|同情する|共感する	anc
pond	池|泉水|沼	anc
fork	フォーク|分岐点	anc
guardian	保護者|守護者|監視者|後見人	anc
congregation	集会|集合|会衆	anc
oxidation	酸化	anc
tin	スズ|ブリキ|すず製容器他	original
warrior	勇士|武人|武士|軍人	anc
officially	公式に|職務上	anc
leverage	てこの作用|借入金で投資する|利用する|utilize	anc
stern	厳格な|きびしい|いかめしい|苦しい|断固たる|船尾	anc
vaccine	ワクチン(の)|痘苗(の)	anc
abruptly	突然に	anc
moisture	水分|湿気	anc
popularity	人気|評判|大衆性	anc
bloom	開花させる|栄える|花が咲く|若さ|美人|花盛り|開花|花	anc
armor	よろいかぶと|よろい|防護具	anc
seize	をつかむ|を理解する|つかむこと|差し押さえ|奪取	anc
boast	自慢する	anc
revision	改訂|改正|手直し|加筆|是正|校閲|改訂版|復習	anc
liable	責任を負うべき|義務である|法的責任のある|しがちな	anc
multitude	多数|群集|大衆|大勢	anc
jealous	嫉妬深い|しっと深い|ねたんで	anc
straw	わら製の|麦わら|ストロー	anc
compact	ぎっしり詰まった|コンパクトな|小型車|小型|(二国間または多国間の)盟約|盟約を結ぶ	anc
auditor	監査役	anc
corpus	文章の収集|集成|死体	original
communist	共産主義者	anc
applicant	志願者|応募者	anc
controversial	議論好きの|議論の|論争上の	anc
nonsense	たわごと|無意味	anc
carcinoma	癌腫	original
spectacle	見世物|光景|壮観	anc
publish	出版する|を発表する	anc
differentiate	を他と別のものにする|を区別する|を変更する	anc
strap	縛る|固定する|を革ひもで縛る|吊皮|革ひも|つり革|革紐で縛る|ストラップ	anc
stalk	茎|軸|細長い支え|煙突|忍び寄る|大またに歩く	anc
locally	局所的に|場所的に	anc
defect	不足|欠点|短所|欠陥|亡命する|他国へ逃亡する	anc
simplicity	単純|平易|質素|純真	anc
discretion	行動の自由|思慮深さ|慎重さ|判断力|決定権	anc
amplitude	振幅	anc
calmly	静かに	anc
buzz	がやがや言う|ざわめき|音|ブンブン|ハチの音|ブザーで呼ぶ	anc
messenger	使者|使い走り	anc
sexy	(性的に)魅力的な|セクシーな	anc
coil	ぐるぐる巻く|コイル	anc
prosperity	繁栄|繁盛|成功|幸運	anc
taxi	タクシー|タクシーで行く|陸上をゆっくり進む	anc
reservation	予約|保留	anc
polite	礼儀正しい|行儀がよい|丁重な|上品な|洗練された|丁寧な	anc
affirm	肯定する|断言する|確認する|確信する	anc
articulate	はっきり言う|はっきり発音する|明瞭な|(関節で)繋ぐ|関連づける|(文法)分節する|文節する	anc
whistle	笛|警笛|口笛を吹く|口笛|汽笛|ヒューと音をたてる|を口笛で吹く|笛で合図する	anc
elementary	初歩の|初めの|初等の|基本の	anc
lick	打つ|負かす|全速力で進む|(舌で)なめる|なめること|一なめ分|(a lick)少し|少量	anc
closure	締切り|閉店|閉鎖|締め切り	anc
hut	簡易住居|小屋	anc
conceal	の中に身を隠す|隠す|を秘密にする|に潜伏する	anc
intentionally	わざと	anc
cortex	(解剖)皮質|外皮	anc
dysfunction	機能障害	anc
spill	こぼすこと|をこぼす|をばらまく|流す|溢れる|浪費する	anc
ignorant	無知から起こる|無知の|無学の|教育のない	anc
persist	固執する|やり通す|主張する|続く|残る	anc
dramatically	劇的に	anc
template	テンプレート|定形書式|鋳型	original
encouragement	励まし|促進	anc
questionnaire	アンケート|質問|質問書	anc
lately	近ごろ|最近	anc
hesitation	ちゅうちょ|ためらい	anc
mentally	心で|精神的に|知的に	anc
max	マックス|最大の	anc
subset	部分集合	anc
fitness	適当|健康	anc
toast	トースト|乾杯(する)	anc
garlic	ニンニク	anc
proximity	近接|近似	anc
outlet	(チェーンの)店(｢販売代理店｣が原義)|販路|小売店|コンセント|出口|はけ口	anc
beef	牛肉|問題|不満	anc
terrorism	テロ行為|恐怖政治	anc
vitro	in vitro 試験管内で(=生体外で)|in vivo (in the body) 生体内で	original
pencil	えんぴつ	anc
insert	挿入する	anc
supportive	協力的な|支持する	anc
anticipation	予期	anc
imagery	イメージ|像	anc
atomic	原子の	original
outbreak	勃発|突発|発生|暴動	anc
rebellion	謀反|暴動|反乱|むほん|反抗|造反|反逆	anc
parental	親の|親にふさわしい	anc
cum	「付き」の意|精液	anc
spontaneous	自発的な|自然な|自然に起きる|自然に起こる	anc
intact	そこなわれていなくて|そのままで|完全で	anc
offensive	不快な|いやな|攻撃|攻勢|無礼な|攻撃的な	anc
wavelength	波長	anc
spinal	とげの|背骨の	anc
gossip	うわさ話をする|うわさばなし|陰口|悪口|噂	anc
timber	材木|木材|森林|樹木|材料	anc
tire	を疲れさせる|を飽き飽きさせる|タイヤ	anc
cancel	無効にする|取消し	anc
endeavour	努力する	anc
infer	を推論する|結論する|を察する|推察する	anc
traditionally	伝統的に|古来	anc
geography	地理学|地形	anc
interrupt	話しを邪魔する|の邪魔をする|を妨害する|を中断する|口を挟む	anc
wilderness	荒野|だだっ広いところ|ごたごたした集まり	anc
whoever	だれでも|だれであっても|する人は誰でも|だれが～しようとも|いったいだれが	anc
friction	摩擦|不和	anc
diminish	小さくなる|減らす|減少する	anc
retention	保持(率)|保有|滞留|うっ滞(性)	anc
vacuum	真空地帯|真空の|掃除機で掃除する	anc
conjunction	結合|連結|合同|(文法)接続詞	anc
computational	計算の	anc
restraint	妨げとなるもの|抑制|制止|拘束|監禁|遠慮|慎み|自制|制限	anc
feminine	女の|女性の|(文法)女性(の)	anc
conform	従って行動する|一致する|従わせる|従う	anc
approve	を承認する|賛成する|を気に入る	anc
alignment	照準|配列|アラインメント|一直線|配置|整列	anc
submission	服従|従順|寄託|提案|提出|仲裁付託|(レスリング)押さえ込みに屈すること	anc
stabilize	固定させる|安定させる(する)	anc
supporter	サポーター|支持者|扶養者|支柱	anc
textbook	教科書	anc
goodbye	さようなら(=goodby)	anc
nutrition	栄養物摂取|栄養物|滋養の|食物	anc
discern	見分ける|認識する	anc
diplomatic	外交の|外交上の	anc
instability	不安定|不安定性(度)(率)	anc
dependency	依存(の状態)|属国|保護領	anc
vacation	休暇|休日|休み	anc
cognition	認識(力)|知識	anc
multiply	掛ける|増加させる|増やす|増える|増す	anc
retrieval	取り返し|挽回|回復|修正|検索	anc
forum	評議会|大広場|フォーラム|公開討論の場	anc
legally	法律的に|合法的に	anc
rack	棚|枠|苦しめる|ちぎれ雲	anc
oppression	圧迫|憂鬱	anc
manipulation	操作|巧みな操作|市場操作|ごまかし|触診	anc
warfare	戦闘状態|戦争|交戦|闘争|争い	anc
sermon	(教会での)説教|お説教|小言	anc
govern	統治する|決定する|を抑制する|を管理する|を左右する	anc
destructive	破壊的な	anc
toe	足指|あし指|つま先|蹄鉄の前部|先端	original
patron	(仏語)パトロン|守護聖人|ひいき客|後援者	anc
inspect	検査する|調べる	anc
bucket	バケツ	anc
opt	選択する	original
vocal	ボーカル|声の|口頭の|声楽の|有声音|母音|声楽	anc
theorem	法則|定理(=axiom)|原則	original
mayor	市長	anc
addiction	熱中すること|夢中になること|-中毒	anc
deer	シカ|鹿	anc
goddess	女神	anc
swell	膨らむ|を膨らませる|隆起(する)|増大(する)|(口)すてきな	anc
reactor	(陽性)反応を示す人|反応者|反応器|反応炉|原子炉	anc
refusal	拒否|拒絶	anc
reconcile	を和解させる|仲直りさせる|に甘んじる|満足させる|を調停する|諦めさせる|承諾させる	anc
pledge	誓約|質入|乾杯|を誓う|人質|保証する	original
pardon	を許す|許し	anc
hike	ハイキングをする|引き上げる|値上げする|increase|raise	anc
tropical	熱帯の|熱帯性の|非常に暑い|猛暑の|回帰線の	anc
mitigate	和らげる|緩める	anc
sweep	さっと通過する|を一掃する|掃除する|(～を)掃く|を掃いて集める|圧勝する|大勝する	anc
harbor	(考え･計画など)を心にいだく|をかくまう|港|避難所	anc
nationalism	民族主義|愛国心|愛国主義	anc
ounce	1オンスは28.3グラム	original
ink	インク|調印する|sign	anc
gauge	標準寸法|規格|尺度|計器|レールの軌間(ゲージ)|判断基準|測る	original
rude	教養のない|無作法な|無礼な|野蛮な|粗野な	anc
refuge	避難する|避難|保護|避難所|隠れ家	anc
butt	(獣が)角で激しく突く|(俗)尻|けつ|つつく	anc
rejoice	を楽しませる|うれしがる|喜ぶ|祝う|を喜ばせる|喜び	anc
cohort	(古代ローマ)歩兵隊|軍隊|仲間|相棒	anc
hostility	戦争行為|敵意|敵性|敵愾心|反抗|敵対行為|反対|対立	anc
municipal	市の|内政の|局地的な|地方自治の|市営の	anc
provincial	田舎風な|地方の|国の|県の|いなかの|地方人|偏狭な人	anc
bull	乱暴なことをする|がっしりした男|頑固な|強気筋|雄牛|雄|ブルドック	anc
splendid	輝かしい|華麗な|壮烈な|みごとな|豪華な|立派な|すてきな	anc
broker	ブローカー|仲買人	anc
receipt	受け取ること|レシート|受領|領収書|収益|受領書	anc
diffuse	散らす|拡散させる	anc
garage	ガレージ|車庫	anc
thereof	その|それの	anc
salad	サラダ	anc
nationalist	国家主義者|国民党員|国家主義の	anc
elephant	ゾウ|象|米共和党(Republican Party)の象徴	anc
peptide	ペプチド|決まった順番で様々なアミノ酸がつながった分子	anc
bitch	雌犬|(卑語)淫乱な女|意地悪で不愉快で身勝手な女|不平･不満を言う	anc
vegetable	植物人間|野菜|植物|活気の無い人	anc
amid	〜の真っ最中に	original
sect	教派|派閥|分派|学派	anc
antigen	抗原	anc
painter	画家|ペンキ屋|塗装工	anc
honestly	いやはや|正直に|誠実に|正当に|正直に打ち明けて|まとも|実直|真面目	anc
incomplete	不完全な	anc
breakdown	突然の故障|機能停止|挫折|崩壊|内訳|分類	anc
obedience	服従|従順	anc
stool	丸椅子|腰掛け|足のせ台|2便器|大便(=excrement)	anc
prosecution	起訴|告発|検察当局|遂行|実行|追求	anc
disruption	分裂|崩壊|混乱	anc
decisive	決定的な|断固とした	anc
scholarly	学者らしい|学術的な|学問的な	anc
exceptional	例外の|異常な|例外的な|異例の|特別に優れた	anc
afterward	あとで|後に	anc
mold	形作る|(に基づいて)作る|土|沃土|肥土|型|鋳型|流し型|骨組み|鋳物|性質|カビ	anc
traumatic	衝撃的な	anc
legislature	立法府	anc
elder	年長者|年上の 2|ニワトコ	anc
heavenly	すばらしい|天の	anc
alloy	合金|合金に用いる安価な金属|まぜ物|品位|純度	anc
median	中央の|正中の|メジアン|中点	anc
distribute	配送する|分配する|分布している	anc
urine	尿	anc
societal	社会の|社会的な	anc
quarrel	四角い鏃の付いた矢|紛争|口論|反目|不和|争う	anc
ibid	同書に|同上	anc
bless	を神聖にする|感謝する|祝福する|恩恵を与える|清める|恵む|賛美する|十字を切る|祈る	anc
adhere	執着する|堅く守る|粘着する|支持する	anc
reproduce	を生殖させる|を複製する|を模写する|を再生する	anc
er	あー|あのー|えーと	anc
consume	消費する	anc
junction	連絡駅|連結|接合(部)|ジャンクション|はね橋|接合器|接点|多重ノード	anc
reactive	(刺激に対して)敏感な|反応の早い|反作用的な	anc
baseball	野球	anc
courtesy	礼儀正しさ|礼儀	anc
intuition	直観	anc
idiot	まぬけ|ばか|あほう	anc
induction	就任式|帰納法|誘発	anc
calendar	カレンダー(calenderはミススペル)	anc
cinema	映画館|映画	anc
basement	地下室|基底部|地階	anc
cooperate	協同する|協力する	anc
tackle	取組む|タックル(する)|道具|ろくろ	anc
organism	有機体|生物|人間|個々の小さな動･植物|有機的組織体(社会など)	anc
batch	一揃い|(電算)バッチ(一度に処理するデータの束)|一群|(手紙の)一束|(パンなどの)一焼き(分)|一回分(のもの)|一団	anc
math	数学|mathematics	anc
trim	刈込む|整備(する)|削減する|を装飾する|(身体の)調子|気分|きちんとした	anc
unclear	あいまいな	anc
prescription	処方(箋|薬)|指示|規定|規範|法規|時効|おきて	anc
surplus	黒字|剰余|余剰|余り|余った|過剰の|余剰の|黒字の	anc
moreover	その上|なおその上に	anc
suite	一続きの部屋|一式の家具|一組|スイート|スイートルーム(和製英語)	anc
leisure	ひま|暇(な)|余暇|用事のない|有閑の|レジャー	anc
harmful	害をおよぼす|有害な	anc
tragic	悲劇の|悲劇的な|悲劇に関する|悲劇を演じる|悲惨な	anc
slender	ほっそりした|不十分な|細長い|わずかな|薄弱な	anc
conceive	考える|思い付く|想像する|妊娠する	anc
specimen	見本の|標本|見本|試験片|試料	anc
darling	いとしい人	anc
flank	側面に立つ|横腹|脇腹|側面(に立つ)|側面を守る|わき腹	anc
fossil	化石	anc
reservoir	貯蔵所|宝庫	anc
indirectly	間接に|二次的に|暗に|間接|それとなく|当て付ける|やんわりと	anc
inhibition	抑制|禁止|禁制|防止|抑圧	anc
instrumental	役に立つ|計測(計器)による|(文法)助格(の)	anc
compliment	お世辞を言う|誉める|賛辞|お世辞|あいさつ	anc
reinforcement	補強|強化	anc
elastic	融通のきく|伸縮自在の|flexible|快活な	anc
cargo	船荷	anc
fury	憤慨|激怒|激しさ|憤激|怒る|激情	anc
enhancement	強化	anc
attendant	付添いの|係員|コンパニオン(和製英語)	anc
convergence	一点に集まること|収束|輻輳	anc
nonetheless	それにもかかわらず|やはり	anc
inscription	刻むこと|銘刻|銘|碑文|the inscription on a gravestone墓碑銘	anc
computation	計算(法)|評価	anc
neighbourhood	近所の人々	anc
knit	編んだ|組む|編む	original
aggression	攻撃|侵略	anc
prone	の傾向がある|のくせがある|しがちな|うつぶせの	anc
hum	ブンブン音をたてる|鼻唄をうたう|景気がよい|ぶんぶんいう音|buzz	anc
sore	痛い	anc
cylinder	シリンダー|円筒	anc
reluctant	気乗りのしない|不承不承の|しぶしぶの|嫌がる	anc
halfway	中途半端な|中途の|中間の|中間にある|中間で|途中で	anc
discomfort	不快にする|不便	anc
plantation	栽培場|大農場|大農園|植林地|植民地	anc
civic	市民の|市の	anc
amusement	楽しみ|娯楽	anc
operative	働く|活動する|(法律が)効力のある|(薬が)ききめのある|有効な|職人|スパイ	anc
architectural	建築の|建築学の	anc
monkey	サル|いたずら小僧|遊び回る|いじくる	anc
stride	大股で歩く|またぐ|一またぎ|進歩	anc
proliferation	増殖|急増|拡散|(生物)分芽|分裂|増殖	original
thigh	もも|また|太腿(尻から膝まで)	anc
selfish	わがままな|利己的な|自分勝手な	anc
fare	料金|運賃|旅をする|暮らす|ごちそう	anc
deed	行為|行い	anc
dip	下落|落下|一汲み|をちょっと浸す|を汲み上げる|下降する|decline|decrease	anc
enjoyment	楽しみ	anc
limb	の手足(翼)を断つ|手足|大枝|縁|節	anc
lawn	芝生	anc
transparency	透明度|透明性	anc
recommendation	推薦(状)	anc
constraint	強制|圧迫|束縛	anc
temporarily	仮りに|仮に|当座|一時的に	anc
contempt	軽べつ|軽蔑|侮辱	anc
producer	生産者|演出家|製作者|興行主|経営者	anc
relieve	を救う|を和らげる	anc
assay	含有量(率)を示す|試金(含有量の検査)する|評価する|検定する	anc
gorgeous	華麗な|豪華な|見事な	anc
rebuild	再建する	anc
electoral	選挙の	anc
awe	畏敬|畏怖	anc
crude	天然のままの|粗野な|露骨な|粗い|加工していない|不遠慮な	anc
fortunate	しあわせな|幸運の|運の良い	anc
suspension	負債の返済不納|吊すこと|停止|宙吊り|未決定|停職	anc
burial	葬式|埋葬|墓	anc
deployment	展開	anc
solidarity	団結|連帯|一致	anc
tick	カチカチいう音|カチカチと音を立てる|時を刻む|ダニ|いやなやつ	anc
satisfactory	満足な|十分な	anc
fatty	脂肪質の|油っこい|脂肪性の|脂肪の|デブ	anc
empathy	感情移入|共感	anc
splash	ねる|をはねかける|バシャ|水のはねる音	anc
brace	突っ張り|支柱|引き締める|支える|元気を出す|元気づける	anc
pastor	牧師	anc
extensively	広く|手広く|大々的	anc
rider	ライダー	anc
elicit	引き出す|導きだす	anc
disk	円盤	anc
ascertain	突止める|確かめる|突きとめる|確実にする	anc
vegetation	(集合的に)植物|植生|植物の発育|無為の生活	anc
realise	realizeの英式綴	anc
bin	(ふた付の)大箱|(石炭, 穀物の)置き場	original
parish	教区(民)|郡|巡回区域|専門分野	anc
abdominal	腹部|腹部の	anc
dioxide	二酸化物	anc
marker	マーカー|マークする物|目印|採点者|記念碑	anc
liberation	解放	anc
lively	active|生き生きした|泡立つ|新鮮な|陽気な|効果的な	anc
statutory	法令の|法定の	anc
murmur	つぶやき|不平の声|かすかな音|ささやく|ざわめく	anc
stitch	を縫う|ステッチ|一針|綴じ|ひと針|縫い目|布地	anc
downward	下向きに|下方へ	anc
portal	入口|門脈|入り口|玄関|正門	anc
announcement	発表|通知	anc
nurture	滋養物|養育|養う|育てる	anc
dominance	優越|支配|優勢	anc
consultant	コンサルタント|顧問|相談役	anc
missile	ミサイル|飛び道具	anc
coherent	首尾一貫した|同位相の|密着した|筋の通った|一貫した	anc
envy	うらやむ|うらやみ|羨望	anc
reproductive	再生(再現)の|生殖の|多産の	anc
dam	せき止める|ダム	anc
wax	ろう|ろう状物質|ワックス|レコード|耳あか|激怒|大きくなる|かんしゃく|満ちる	anc
junior	年少の|年少者	anc
apology	弁解|言い訳|謝罪|(口)まにあわせのもの	anc
conquest	占領地|征服	anc
swift	迅速な|迅速に|敏速な|非常に速い	anc
sediment	沈澱物|沈殿物|堆積物	anc
conditional	条件付きの|条件的な|(文法)条件文|条件語句(節･文)	anc
slap	非難(する)|平手打ち|をピシャリと打つ(こと)|ピシャ|ひっぱたく音	anc
meantime	合い間|その間の時間	anc
jam	混雑|ジャム|妨害する|詰め込む	anc
canvas	研究調査する|遊説してまわる|選挙運動をする|カンバス|キャンバス|テント|麻布|帆布|ズック	anc
blossom	(特に果実の)花が咲く|開花する|発展する	original
beneficiary	受取人|受給者|受益者|信託受益者	anc
recognise	認識する	anc
analyse	分析する	anc
propaganda	宣伝|主義|主張|宣伝機関	anc
lump	塊になっている|重そうに動く|たくさん|角砂糖|こぶ|塊	anc
prophecy	予言的能力|予言|お告げ|天啓|預言	anc
emotionally	感情的に	anc
sincere	誠実な|偽りのない|正直な	anc
bilateral	二国間の|両国間の|両側の|左右相称の|相互的な|双務的な|両側のある|双方の	anc
confirmation	売買報告書|確認	anc
incorrect	正しくない|間違った|無作法な	anc
purity	清浄|混じり気のないこと|純粋|純度|清潔|純潔|清廉|正格	anc
winner	勝利者|受賞者	anc
distraction	精神錯乱|気晴らし	anc
premium	割増価格|割増金|賞与金|賞|賞金|賞品|賞与|割り増し	anc
ambitious	大望のある|野心的な|熱望して	anc
tourist	観光客|旅行者	anc
align	並べる|一直線にする|提携させる|一列に並べる	anc
predominantly	優勢に|主に|大部分は|広く|支配的な	anc
provoke	引き起こす|刺激する|を怒らせる|をじらす|挑発する	anc
chap	男|あかぎれ|ひび(あかぎれ)を作る|(手などが)荒れる|(動物の)あご|ほお	anc
affinity	類似性|親近感|魅力|attraction|婚姻(関係)	anc
nephew	おい|甥	anc
shrug	肩をすくめる(こと)	anc
fundamentally	根本的に	anc
unwilling	気が進まない|いやがる|不本意の|いやいやながらの|反抗的な	anc
drought	日照り|かんばつ|旱魃|渇水	anc
fibre	fiber(繊維)の英国式綴り	anc
circumstance	ものものしさ|出来事|事情･環境|状況|境遇|身の上	anc
rehabilitation	社会復帰|名誉回復|復権|復興	anc
gel	ゲル|膠(こう)化体	original
spiral	らせん状に進む|らせん|螺旋状の|螺旋形のもの	anc
countenance	に暗に賛成する|表情|外見	anc
collision	衝突	anc
motivate	に動機を与える|動機を与える|やる気にさせる	anc
spoon	スプーン	anc
landlord	家主|地主	anc
fuzzy	ぼやけた|微毛のある|けばだった|縮れた|ファジー理論	anc
scientist	科学者	anc
immigrant	帰化植物|移住者|移住民|(外国からの)移民|外来動物	anc
ml	ミリリットル(1cc)	anc
fort	とりで|交易市場|要塞	original
warehouse	を倉庫に入れる|を保税倉庫に預ける|商品保管所|卸売り店|問屋|倉庫|大商店	anc
restriction	制限(条件)|限定	anc
periodic	定期的な|周期的な|断続的な	anc
clash	衝突(する)|ガチャッ(音)|(色彩の点で)調和しない	anc
atom	原子	anc
righteousness	正義|正直|正しさ|実直	anc
summit	首脳(陣)|山頂|頂点|首脳会談|首脳レベルの	anc
transmit	伝える|convey|を送る|を伝達する|送信する|発信する	anc
cute	かわいい	anc
naval	海軍の	anc
mum	黙る|無言の|黙っている|しっ!|奥様|おかあちゃん|強いビール|キク	anc
costly	高価な|損失の大きい	anc
sack	解雇(する)|袋(にいれる)|袋の中身|大袋	anc
disagreement	不一致	anc
accomplishment	達成|完成|才能	anc
boot	長靴|解雇|クビ|(UK英)車のトランク	anc
flush	ほおがぱっと赤らむ|(空が)ばら色になる|メモリをクリアする	original
irregular	でこぼこの|不揃いの|不同の|不規則な|変則的な|(文法)不規則変化の	anc
worm	虫|寄生虫|虫けら|苦悩|徐々に進む|寄生虫を取り除く	anc
evolve	展開する|発展させる|導きだす|発展する	anc
outfit	したく|用具一式|一行|供給する	anc
eagerly	熱心に	anc
immunity	(税･責任･義務などの)免除|免疫性|免疫	anc
longitudinal	経度の	anc
sickness	病気	anc
bud	つぼみ|芽	anc
foam	泡|あぶく|泡を出す|あわ消化剤	anc
negotiation	交渉|話し合い|(小切手など)譲渡|談判|流通	anc
rub	こする|障害|摩擦	anc
download	ダウンロード	anc
laptop	ひざ置き型の|小型で携帯可能な|ラップトップの	anc
compatible	両立できる|矛盾のない|(ソフトウェアなどで)互換性がある	anc
feasible	実現可能な|可能な|適した|便利な	anc
deformation	形をくずすこと	anc
solemn	いかめしい|厳粛な|まじめな	anc
viable	生存できる|実行可能な|生存能力のある	anc
coincide	一致する|同時に起こる|性質が合う|同じくする	anc
speculation	投機|思惑買い|思索|思弁|考察|空論|推測|やま	anc
icon	聖像|像|肖像|イコン|偶像|アイコン	anc
safeguard	予防手段|防護手段(対策)|緊急輸入制限	anc
solitary	孤独の|ひとりの|一人だけの|孤独な|めったに人の訪れない	anc
sculpture	彫刻をする|彫刻する|彫刻|彫刻作品	anc
scarce	まれな|不足して	anc
reliance	依存|信頼	anc
unpleasant	不愉快な|いやな|気にさわる	anc
summon	を招集する|を呼び出す|勧める|命令する|要求する	anc
earnest	まじめな|熱心な|真剣な|重大な	anc
streak	筋がつく|閃く|層|線|光線|一続き|兆候	anc
dreadful	恐ろしい	anc
proportional	比例した|釣り合った|比例項|比例の	anc
plug	差し込み|消火栓|栓|プラグ|ソケット|点火栓|をふさぐ|宣伝(する)	anc
coupling	男女のカップル	anc
gradual	(勾配が)ゆるやかな|漸次の|徐じょの|徐々の|漸進的な|逐次の|昇階唱	anc
abortion	人工中絶|堕胎|流産|早産|(器官の)発育不全	anc
interactive	インタラクティブな|対話式の|実況の|最新の	anc
individually	個々別々に	anc
deity	神|神性	anc
biomass	生物量|バイオマス|生態学で	original
murderer	人殺し|殺人者	anc
sunshine	日向|日光	anc
chromosome	染色体	anc
republic	共和政体|共和国|～団体|～社会	anc
colleague	同僚|仲間	anc
coarse	粗野な|あらい|粗末な|粗い	anc
suck	ひとすすり|吸う|しゃぶる|ひどくいやな|むかつくような|最低の	anc
attendance	出席	anc
advertisement	広告	anc
contingent	依存する|付随する|偶然の|臨時の|不慮の出来事|分担|分艦隊|派遣団	anc
signify	を意味する|を示す	anc
teaching	教育|授業|教え|教義	anc
imprint	強く印象づける|押印|感銘させる	anc
captive	捕らわれた|人質(=hostage, pawn, pledge, captive)|とりこ(の)	original
ripple	波紋ができる|に波紋を起す|波状|細波が立つ|波紋|さざ波	anc
viral	ウイルスの|ウイルス起因の	anc
ethnicity	民族性	anc
tech	技術の|科学技術|技術者	anc
slaughter	大量殺戮|完敗|屠殺する|虐殺する|徹底的に打ち負かす	anc
intimacy	仲の良い|親密|親しい|個人的な|私事の|精通した	anc
retire	退職する|引退する	anc
hood	ずきんをつける|ずきん|フード状のもの	original
overnight	夜通し|一晩中|前夜の|一夜のうちに	anc
wreck	難破|難破船|破損|廃人|破壊する|難破させる	anc
critically	きわどく|危うく|危なく|危篤状態に|酷評して|批判して|批評的に	anc
culturally	文化的に	anc
advancement	傷心|進歩|促進	anc
scandal	スキャンダル|醜聞|恥ずべきこと	anc
spur	を駆り立てる|に拍車をあてる|急行する|激励|刺激|拍車	anc
paste	をのりではる|ねり物|ペースト|のり|練り粉	anc
neat	さっぱりした|きちんとした|こぎれいな|趣味のよい	anc
nonlinear	非線形の	anc
affective	感情の	anc
hurriedly	あわただしく|大急ぎで	anc
revolt	暴動(を起こす)|反乱|背く|反抗する|暴動を起こす|不快に感じる|一揆|反感	anc
intellect	知性	anc
dismiss	解雇する|fire|立ち去らせる|追放する|解散する|(本来なら考慮すべきことを)忘れる	anc
incredibly	信じられないほど|非常に	anc
spoil	悪くなる|を台無しにする|駄目にする|を甘やかす|役に立たなくする	anc
perish	を殺す|滅びる|死ぬ|消滅する|悪くなる|堕落する	anc
transnational	多国籍企業|国家を越えた|国境を越えた|多国籍の|国という枠組みを超えた	anc
bronze	青銅|ブロンズ	anc
lust	切望する|強い色情をいだく|(通例好ましくない)欲望|強い性欲	anc
waiter	給仕|ボーイ	anc
audio	可聴周波数|音響部分|聴覚の	anc
offend	怒らせる	anc
policeman	警官	anc
unfortunately	あいにく|不幸にも|不運にも	anc
narrator	ナレーター	anc
offspring	子孫|結果|成果	anc
terminology	専門用語|術語|用語法|術語学	anc
chapel	礼拝堂	anc
rationale	理論的解釈|根本的理由|原理|理論的説明(根拠)	anc
integer	(ínṭɪdʒɚ)完全なもの|完全体|(数学)整数|整数値	anc
doll	人形	anc
pearl	真珠(の)|を真珠で飾る|真珠色	anc
swiftly	すばやく|迅速に	anc
convenience	便利なもの|都合|便利	anc
acceleration	加速|促進	anc
rim	リム|へり|枠|ふち	anc
refrain	差し控える|差控える|断つ|抑制する|謹む|こらえる|やめる|我慢する	anc
thrill	をぞくぞくさせる|ぞくぞくする|を感動させる|震え|振動|スリル	anc
casually	何気なく|偶然|思いがけなく	anc
terrace	段地	anc
cult	礼讃|信仰|宗派	anc
angrily	怒って	anc
microbial	微生物の	anc
iteration	反復	anc
torment	に肉体的苦痛を与える|を困らせるを苦しめる|を悩ます|苦労の種|苦痛|苦悩|拷問	anc
mansion	大邸宅	anc
spectral	お化けの(ような)|怪奇の|スペクトルの	anc
comedy	喜劇	anc
mesh	網目|網の目|網|わな|網で捕らえる|かみ合わせる|協力させる	anc
plea	嘆願|陳述|弁解|抗弁	anc
resurrection	回復|蘇り|復活|復興	anc
customary	習慣的の|慣習の|いつもの|例の	anc
custody	拘留|保護|管理|拘置	anc
obesity	(医)肥満|肥満体	original
bowel	腸|内臓	anc
descriptive	記述的な	anc
workforce	(作業)要員|総労働力|労働|労働人口	anc
scare	こわがらせる|おどして～させる|おびえさせる	anc
utilization	利用	anc
substantive	名詞相当語句(形容詞句|節など)|実詞	anc
detector	発見者	anc
unstable	不安定な|安定していない|動きやすい|ぐらぐらする|不安定|今にも崩れそうな|気が変わりやすい	anc
isolate	孤立させる|を離す|隔てる|を隔離する|を絶縁する	anc
premise	を前提とする|前提|根拠|既述事項|財産|不動産|家具|建物|土地|構内	anc
daylight	昼の明かり|日光|公然|公表|理解|透き間	anc
sheriff	郡保安官	anc
efficiently	能率的に|効果的に	anc
agony	苦痛|煩悶	anc
contemplate	熟考する|凝視する|予期する|直視する	anc
fearful	恐ろしい	anc
vivo	in vitro 試験管内で(=生体外で)|in vivo (in the body) 生体内で	original
caste	階級|(社会的)地位|カースト|階級制	anc
float	浮くもの|浮かぶ|浮く	anc
relaxation	気晴らし|くつろぎ|息抜き|ゆるみ|弛緩|緩和	anc
disregard	無視する|軽視する	anc
specificity	特異度|特定性|特異性|無病正診率	anc
parliament	議会|国会|英国議会	anc
disc	レコード|円盤	anc
bury	没頭させる|～隠す|を埋める|を埋葬する|を忘れる	anc
notebook	ノート	anc
renewable	更新しうる|再生しうる	anc
communal	地方自治体の|公共の|全住民が共有する	anc
absurd	ばからしい|不合理な|ばかげた	anc
offset	分かれ|分派|オフセット(印刷)|埋め合わせ|相殺|相殺する	anc
prototype	プロトタイプ|原型|手本|試作|模範	anc
brake	ブレーキ|歯止め|制動機|(植物)シダ|ワラビ	anc
adequately	適切に	anc
responsive	すぐ反応する|敏感な	anc
hastily	あわてて|急いで	anc
console	悲しみを和らげる|を慰める|を元気づける	anc
album	アルバム	anc
ribbon	インクリボン|リボン|飾りひも|ひも状のもの	anc
termination	終了|接尾辞	anc
venue	会場|集合場所|(行動･事件の)現場	anc
inappropriate	不適当な	anc
nominal	名目上の|名称上の|名詞の|名詞語句	anc
virgin	純潔の|未婚婦人|修道女(まれ)	anc
viewpoint	見解|見える地点|観点	anc
puff	ぷっと吹く(こと)|ひとふき|たばこの一服|ふくれること|息を切らす|煙を吐く|を膨らませる	anc
morphology	形態論|形態学|形態(学･論)	anc
ambiguity	あいまいさ|両義性|両義にとれる表現	anc
inn	宿屋	anc
vivid	生き生きとした|生気にみちた|(色･光)鮮明な|強烈な|(色に関して)鮮やかな	anc
rally	再び集める|元気づける|回復(する)|反騰(する)|大会|集会	anc
mandatory	強制的な|命令の|統治を委任された|委任の	anc
creator	創造者|創作者|創設者|創始者	anc
promptly	すぐに|敏速に|即座に|ぴったり	anc
lesion	障害|病変|外傷|損傷|病気による組織の変形	anc
dictionary	辞書	anc
susceptible	影響を受けやすい|敏感な|感染しやすい|を許す|可能な	anc
indulge	欲望を満足させる|ふける|耽溺する|深酒する|気ままにさせる|甘やかす	anc
tiger	トラ|乱暴者|強敵|狂暴な(残酷な)人|歓呼|喝采	anc
bug	虫|ナンキンムシ|微生物|バイ菌|熱狂家|欠陥点|盗聴器|盗聴する|いらいらさせる|困惑させる	anc
stagger	よろけ|よろめく|二の足を踏む|動揺させる|ずらす	anc
drawing	引く|製図|素描|鉛筆で描く絵	anc
layout	並べること|広げること|割り付け	anc
resemblance	類似|似ていること	anc
imitate	を手本にする|を模倣する|をまねる	anc
greet	あいさつする|挨拶する|反応する|知覚される	anc
contraction	短縮|縮小|制限	anc
pragmatic	実用主義の|実際的な	anc
compartment	コンパートメント|区画|仕切り	anc
mutually	相互に|双方で	anc
patrol	パトロール(隊)|(～を)巡回する|巡回者	anc
hierarchical	階級の	anc
entail	必要とする|を伴う|限嗣相続の形で譲与する|必然的な結果	anc
distinctly	きっぱり|はっきりと	anc
compute	算定する	anc
shortage	数量の不足|不足|欠点	anc
geographic	地質学上の	anc
peasant	いなか者|小規模農業|小作農|田舎者|農夫	anc
settling	沈降した	anc
dietary	食事の|飲食規定(量)	anc
focal	焦点の	anc
balloon	風船|ふくらむ	anc
coincidence	偶然の一致･出合い	anc
refine	不純物を除く|純化する|精錬|製錬|精練|洗練する	original
modernity	現代性|現代的なもの	anc
inward	本質的な|内へ|内部へ|内陸の|奥地の|内部|内側	anc
cab	タクシー	anc
predicate	を断定する|を意味する|を叙述する|述部|述語	anc
successive	連続的な|継続的な|次の|連続する	anc
idle	遊んでいる|怠ける|怠惰な|仕事のない|何もしない|暇な	anc
countryside	田舎	anc
dash	粉々に打ち砕く|突進する|投げつける|激しく打つ|突撃|活気|a 100-meter dash(100メートル競走)	anc
conspiracy	共同謀議|陰謀	anc
charter	に特許を与える|憲章|憲法|constitution	anc
smirk	作り笑い|(～を)にやにや笑う(at|on|upon～)	anc
soap	せっけん|石鹸|を石鹸で洗う	anc
asylum	亡命|避難|政治犯の庇護|隠れ家|保護施設|避難所|精神病院|孤児院|聖域	anc
journalist	ジャーナリスト|新聞記者	anc
chant	詠唱する|シュプレヒコール	anc
fountain	泉	anc
replicate	(葉など)を折り返す|を模写･複製する	anc
shoe	くつ|靴	anc
riot	暴動に加わる|放蕩する|ふける|暴動|反乱|一揆|多種多様	anc
tread	を踏む|行く|歩く|階段の段	anc
indifferent	差別しない|無関心な|無感動の|冷淡な|普通の|(電気的･科学的に)中性の|不活性の	anc
randomly	無作為に	anc
appropriately	適切に	anc
unfair	公正を欠いた|不公平な|ずるい|不正な|不当な	anc
explosive	爆発しやすい|爆発性の|爆発物	anc
comprehension	理解|包含	anc
tug	を強く引く|引っ張る|引っ張ること	anc
editorial	社説|編集者の|論説	anc
cerebral	脳の	anc
spike	大くぎ|(塀の)忍び返し|(競技用の靴の)スパイク|(植物)穂	anc
thoughtful	思慮ぶかい|考え込んでいる|思いにふけった|考え深い|思慮深い	anc
pixel	ピクセル|画素	anc
butterfly	蝶|チョウ|バタフライ(水泳)	anc
negatively	マイナスに|否定的に	anc
masculine	男らしい|男の|男性|(文法)男性の	anc
contradict	に矛盾する|反論する|反駁する|抗論する|否定する	anc
documentary	ドキュメンタリー|文書の|ドキュメンタリー映画|事実を記録した|記録もの	anc
embarrassment	困惑|困難	anc
alpha	(第1ギリシア文字)アルファ|Α|α	original
heroic	おおげさな|英雄の	anc
sober	しらふの|酔っていない|分別のある|真面目な|冷静な	anc
plausible	もっともらしい|口先のうまい	anc
haired	髪	anc
sow	雌豚|蒔く|種をまく	original
tan	なめす|皮をなめす|皮膚を日焼けさせる|タンニン|黄褐色	anc
terrain	(自然地理･軍事上から見た)地域|地勢|地形	anc
parade	行列|見せびらかし|を行進する|を見せびらかす	anc
composer	作曲家	anc
utmost	最大限の|最上の|極度の|最高の|一番端の|極限|全力	anc
methodological	方法論的な	anc
exempt	免れさせる|免れた|免除する|免疫の|免属の|免税者	anc
mug	(人を暗闇で)襲って金品を奪う|(俗)がり勉する|大型コップ|マグ|ジョッキ|(俗)つら|顔写真を作る|不良|まぬけ	original
cheerful	気持ちのよい	anc
moonlight	月光(の)|(俗)内職(する)|夜間アルバイトをする	anc
betray	裏切る|騙す|だます|漏らす|密告する|秘密をあばく|敵に売る|背く|うっかりもらす	anc
innocence	無垢|潔白	anc
complementary	補完的な	anc
manifestation	発現|明らかにすること|政策表明|徴候	anc
trash	紙くず入れ(=wastebasket)	anc
superiority	優越	anc
migrate	移住する	anc
inclination	したい気持ち|好み|意向|傾斜|傾向	anc
staircase	階段	anc
wherein	どこに	anc
interpersonal	個人間の	anc
symmetry	釣り合い|調和|同情|対称	anc
wool	羊毛|毛糸|毛織物	anc
dementia	認知症|痴呆症(の)	anc
fertility	多産|繁殖力があること	anc
trustee	受託会社|受託者|被信託人|管財人	anc
eternity	永遠	anc
grocery	食料雑貨類|食料雑貨店	anc
psychiatric	精神医学の	anc
investor	投資家	anc
fantastic	風変わりな|異様な|奇怪な|空想的な|気まぐれな|幻想的な	anc
jealousy	ねたみ|しっと|ジェラシー	anc
irrigation	潅がい|潅漑|洗浄	anc
destine	運命づける|～ということになっている	anc
freeze	凍る|凍らせる|氷結→凍ったようにピタッと動きを止める	anc
fox	キツネ|狐|狡猾な人|すごい美人	anc
helmet	ヘルメット	anc
reading	読書力|読書|知識|学識|朗読|読み物	anc
variant	種々の|異なった|相違する|一致しない|変種の|変化	anc
pharmaceutical	製薬の|薬剤の|薬	anc
maker	製造業者|創造主	anc
theirs	彼らのもの	anc
depict	(いきいきと言葉で)描写する|叙述する|描く	anc
tribal	部族の	anc
sunset	夕焼け空|日没|終局	anc
orgasm	オーガズム|激情	anc
backwards	=backward	ejdict
utterance	発声|口に出すこと|発言|話ぶり	anc
cardiovascular	心臓血管の|心血管|心臓血管	anc
incentive	刺激的な|鼓舞する|激励|動機|奨励金|刺激|動機づけ	anc
converge	一点に集める|収束する|集まる|合流|一点に集まる	anc
mobilize	動員する	anc
erosion	浸食|腐食|目減り	anc
paradox	逆説|矛盾|矛盾しているように見える人(物)	anc
substitution	置き換え|代用|代用品	anc
foul	不正な|反則の|不潔な|腐敗した|(天候が)荒れもようの|(綱など)もつれた|下品な|(野球)反則の|ファウルの	anc
bargain	堀り出しもの|駆引きする|交渉する|契約|安い買物	anc
humour	humorのUK式綴	anc
unite	結合する|結合させる|を一つにする|連合させる|一体となる|合体する	anc
vertex	最高点|頂上|山頂|頭頂	anc
supplier	原料供給国|供給者|仕入先|業者|供給業者|納入業者	anc
prohibition	禁酒法時代|禁止	anc
oppose	反対する	anc
practitioner	開業医師|熟練家	anc
precursor	先駆者|先駆物質	anc
heel	のすぐ後に続く|かかと|かかと状のもの	anc
lamb	子羊|柔和な人	anc
notify	発表する|通知する|告知する|届け出る|広告する	anc
anonymous	匿名の	anc
fragile	壊れ物	anc
delightful	喜びを与える|愉快な|楽しい	anc
scripture	(常に複数形で)聖書(の一節)	anc
attach	くっつける|付属させる	anc
linen	亜麻布|亜麻糸	anc
meter	メートル	anc
allowance	協定損害率|～料|割当額|手当|支給金	anc
classify	分類する	anc
alley	路地|alley cat 野良猫|おはじき(遊び)	anc
manufacturer	メーカー|製造業者	anc
navy	(色)ネービーブルー|海軍|海軍力|海軍軍人	anc
invoke	思い起こさせる|(権威あるものを)引き合いに出す|(法律など)に訴える|懇願する	anc
reflective	反射による|反射する|照り返す|考え深い|内省的な|考え込む	anc
offering	提供する|上演|贈り物|販売	anc
eligible	資格のある|望ましい|適任者	anc
administer	施行する|管理する|与える	anc
economically	経済的に|節約して	anc
sanction	許可|拘束|賛成|認定(する)|(複数形で)軍事的･経済的制裁措置	anc
biography	一代記|伝記	anc
preacher	説教者|説教師|牧師|伝道者	anc
bully	いじめる|いじめっ子	anc
celebrity	有名人|名士|名声|テレビによくでる有名人	anc
literal	文字の|文字通りの|融通のきかない|事実に忠実な|誤植	anc
navigation	航海学|航空学|航海術|航海|航空|航行	anc
intentional	計画的な	anc
unfamiliar	なじみのない	anc
rupture	破裂(させる)|裂け目|不和|国交断絶	anc
lament	悲しむ|嘆く	anc
aboard	〜に乗って	original
massage	マッサージ|あんま|按摩術|もみ治療	anc
distal	末端の|先端の	anc
resentment	憤慨|恨み|憤り|立腹	anc
outdoor	戸外の	anc
disciple	弟子	anc
cautious	注意深い|用心深い	anc
juvenile	少年少女(向き)の|若い|少年の|少女の	anc
lag	遅れる|懲役に処する|遅延|前科者	anc
beta	(第2ギリシア文字)ベータ|Β|β|ベータ星(星座の中で2番目に明るい星 cf|α星)	anc
fiercely	獰猛に	anc
recruitment	募集|採用	anc
hypertension	高血圧(症)	anc
prohibit	禁止する|を禁じる|を制止する|を妨げる|予防する	anc
plainly	はっきりと|明らかに|全く|率直に|質素に	anc
adolescent	青春期の	anc
accelerate	の速度を速める|加速する|速める|促進する|増進する	anc
accumulate	積み重ねる|蓄積する|集める	anc
refugee	亡命者|難民	anc
haunt	しばしば訪れる|出没する|とりつかれる|幽霊|～の脳裏に刻み込む|(例|Haunted houseお化け屋敷)	anc
vampire	吸血鬼|人を食いものにする悪人	original
dental	歯の|歯科(用)の|歯音(の)	anc
upgrade	上り坂|(質を)よくする|グレードアップ(和製英語)	anc
antenna	アンテナ|空中線|antennae(antennaの複数形)(æntɛ́ni)(動物の)触角|触毛	anc
makeup	組み立て|構造|性質|化粧	anc
cruise	周遊観光船|航行する|巡航する|歩き回る	anc
balcony	バルコニー	anc
perch	とまり木|高い地位|運転台|郊外|限界|高い場所に位置を占める|パーチ(スズキの類)	anc
trait	特性|特|特色|特徴|習性|一筆	anc
superficial	うわべだけの|表面の|平方の|皮相な|(息が)浅い	anc
chuckle	くすくす笑う|一人で笑う	anc
monastery	修道院|僧院	anc
collector	光捕集器|収集家|集金人	anc
jerk	急にぐいと引く|むだに時間をつぶす|バカ|愚か者|世間知らず(若い人が用いる)	anc
muscular	たくましい|筋肉の|力強い|強健な	anc
textile	織物(の)|編み物(の)	anc
bitterly	ひどく|はなはだしく|冷酷に	anc
formulate	定式化する	anc
morally	恐らく|常識的に|道徳上	anc
initiation	開始|着手|創始|手ほどき|奥義伝授|入会(式)	anc
kernel	核心|核|仁	anc
globalization	グローバル化	anc
brutal	けものの|残忍な|野蛮な|無茶な	anc
skeleton	がいこつ|概略の|骨格|骸骨	anc
rightly	正しく	anc
chiefly	とりわけ|主に|たいてい	anc
antibody	免疫体|抗体	anc
transplant	移植|移住|移住者|移植された植物|を移植する|移住させる|移住する	anc
torch	たいまつ|光|カンテラ	anc
mob	群衆|暴徒|群れ|大衆|暴力団|マフィア|暴徒の群れ|群がり騒ぐ|襲う|群がる	anc
avenue	並木道|大通り	anc
linkage	関連|連関	anc
rhetorical	修辞学の|修辞的な(上の)|美辞麗句の	anc
sanctuary	聖地|聖域|庇護|神殿|保護|鳥獣保護区域|安らぎの場所	anc
scroll	スクロールする|巻き物|渦巻模様	anc
quantify	量を定める	anc
cushion	クッション	anc
mimic	をまねる|まねてからかう|模倣者|偽の|模倣の|模造の	anc
elimination	削除|除去|予選|排除|排泄|淘汰|消去	anc
consciously	意識的に	anc
pavement	舗装道路|舗装|敷石	anc
heterogeneous	異なる|異質の|異種の|異性の	anc
swarm	いっぱいになる|群がる|群れ|昆虫の群れ|群衆	anc
weaken	を弱める|を薄める|弱る	anc
ambiguous	あいまいな|両義にとれる|不明瞭な	anc
vanish	消える|見えなくなる|消音 	anc
penetration	侵入|進出|広告効果|貫通|浸透|洞察力	anc
educate	を教育する|(教養など)を養う|(動物など)を仕込む	anc
wrath	激怒|憤怒|復讐|神の怒り	anc
theft	盗み|窃盗罪|窃盗(罪)|盗塁	anc
downtown	下町	anc
supra	越えて|上に	original
confrontation	対決|直面|直面すること	anc
mutation	突然変異|変化	anc
obstruction	じゃま|障害|妨害|閉塞(症)	anc
wireless	無線の|無線電信	anc
explode	爆発させる(する)|打破する|破裂する|感情が激発する|評判を覆す	anc
stray	はぐれた|道に迷った|話題が本筋から外れる|迷子|浮浪人(stray sheep迷える羊)	anc
contamination	堕落させるもの|汚すこと|よごれ|汚染|悪影響|汚染物	anc
migrant	移住者|移住性の	anc
erect	直立した|強ばった|勃起した|組み立てる	anc
cite	引用する|列挙する|を引き合いに出す|特記する	anc
prevalent	普及した|流行の|一般的な|有力な	anc
visualize	目に見えるようになる(する)	anc
recurrent	再発する|反復	anc
ambassador	大使|使節	anc
surround	を取り囲む|サラウンド	anc
scrutiny	精密な調査|精査	anc
secretion	分泌(物|液)|隠匿|分泌物	anc
quasi	に準ずる(resembling)	anc
dumb	口のきけない|おしの|唖然とした|黙っている	anc
rumble	(車などが)がらがら通る|ごろごろ鳴る|とどろく|ゴロゴロ(雷･腹の音)	anc
permanently	永遠に|不変に|永久に	anc
retrieve	検索する|引き出す|取り戻す|償う|回収する|回復する	anc
setup	装備|構成	anc
dissolve	溶解する|解散する|取り消す|溶かす	anc
lazy	怠惰な|のろのろした|眠気を誘う	anc
catalogue	目録を作る|カタログ	anc
supernatural	超自然の	anc
uncommon	まれな|珍しい|異常の|非凡な|非常に	anc
scrap	屑鉄|屑|小片|断片|切り抜き|くず|をくずにする･解体する|捨てる	anc
analytic	分析的な|分析の|解析幾何学	anc
subsection	小区分	anc
trench	にみぞを掘る|塹壕を掘る|掘る|塹壕|堀|掘割	anc
transcription	写すこと|複写|転写|コピー	anc
lattice	格子	anc
madness	狂気|熱中|熱狂	anc
monopoly	独占|専売|専売品 	anc
uptake	理解|理解力|取り込み|摂取	anc
prevail	流行する|勝る|普及する|効果がある|勝つ|克服する	anc
rental	賃貸しの|使用料	anc
propagation	伝達|伝搬|増殖|繁殖|宣伝|普及|蔓延|遺伝	anc
pat	適切な|すっかり|軽くたたく(こと)|なでること|軽くたたく音	anc
grim	残忍な|厳格な|断固とした|気味の悪い|(表情が)険しい	anc
wander	歩き回る|ぶらつく	anc
conductivity	伝導性(力･率･度)|導電率	anc
inquire	尋ねる(=enquire)|質問する	anc
learner	学習者	anc
decomposition	分解|腐敗	anc
pathology	病理学|病理|病状|前足で掻く|蹄で掻く	anc
brass	真ちゅう|真鍮(色･製品)(の)|黄銅|ずうずうしさ|お偉方|大物	anc
immortal	不死の	anc
epic	叙事詩の|英雄的な|叙事詩(のような)|大作|超大作	anc
timely	適時の|時期を得た|折りの良い|折りよく	anc
procure	獲得する|を得る|を手に入れる|売春婦を周旋する	anc
scaffold	足場を設ける|(建築場の)足場|絞首台|処刑台|(野外の)組立て舞台	anc
earthly	地球の	anc
dough	(俗)現金|生練り粉|パン生地	anc